coach	trainer
founder	gründer
diplomacy	diplomatie
consolidated	festigen
real-time	echtzeit
activated	aktiviert
enjoyable	angenehmer
mild	leichten
disc	cd
cooperative	kooperation
query	anfrage
moon	fliegen
als	than
retention	beibehaltung
layers	schichten
gases	treibhausgasemissionen
pointing	hinzuweisen
hunting	jagd
eligible	berechtigten
subjected	unterzogen
foster	fördern
dairy	milch
tranquillity	ruhe
terror	terror
imperative	zwingend
alternatively	alternativ
dramatically	dramatisch
protective	schutzmaßnahmen
wished	gewünscht
co-operation	kooperation
detention	haft
fat	dicke
coloured	farbe
literally	wortes
advised	beraten
austerity	einsparungen
recreation	erholung
olaf	olaf
dictatorship	diktatur
accompanying	dazugehörigen
stimulus	impuls
louis	louis
shock	auslösen
venue	treffpunkt
upload	laden
moldova	moldau
random	zufällig
settle	klären
saudi	islamischen
enforce	durchzusetzen
comforts	komfort
tel	tel.
portable	mobilen
sap	sap
demonstrations	demonstrationen
licensed	zugelassen
inland	inland
fabulous	fantastischen
booth	stand
rigorous	strengen
dresden	dresden
depression	depression
conscience	gewissen
employ	beschäftigen
hide	verstecken
christ	christus
richard	richard
witnessed	erlebt
liberty	freiheit
experiment	versuch
attitudes	verhaltensweisen
template	vorlage
foodstuffs	lebensmitteln
certificates	zertifikat
bird	vögel
multinational	multinationalen
deemed	erachtet
justification	rechtfertigung
gathered	gesammelt
pushing	drängen
non-governmental	nichtregierungsorganisationen
delivering	erbringung
ranges	reicht
modular	aufbau
disastrous	verheerenden
healing	heilung
separation	trennung
civilians	zivilisten
galileo	galileo
safer	sicherer
auch	siehe
earthquake	erdbeben
clarification	klarstellung
39	39
talent	talent
thirty	dreißig
credits	kredite
brilliant	hervorragenden
riviera	riviera
k	k
unanimity	einstimmigkeit
exceptionally	außergewöhnlich
yacht	schiff
abolition	abschaffung
defeat	niederlage
punishment	strafe
coastline	küste
examining	prüft
invasion	invasion
firefox	firefox
divide	kluft
classification	eingestuft
problematic	problematisch
lending	kredite
feelings	gefühle
psychological	körperliche
sincerely	aufrichtig
vip	vegas
decrease	rückgang
toys	spielzeug
counts	zählt
rarely	selten
opponents	gegner
plot	grundstück
criminals	kriminelle
che	che
chf	chf
distinct	deutlichen
coins	münzen
nobel	träger
oecd	oecd
archives	archiv
passport	pass
theoretical	theoretisch
high-speed	speed
revolutionary	revolution
bulgarian	bulgarischen
preserving	bewahrung
formally	offiziell
supporters	anhänger
limitation	einschränkung
visibility	sichtbar
excuse	entschuldigung
germans	deutschen
democratisation	demokratisierung
hole	loch
mounted	montiert
subscription	abonnieren
decoration	interieur
flora	flora
permits	zulässt
tunnel	57
avoiding	vermeidung
dei	dei
incidents	vorfälle
thin	feinen
praise	lob
entrepreneurs	unternehmer
abandon	aufzugeben
ferry	boote
marble	interieur
fortress	festung
purchaser	käufer
nearest	nächste
prompt	veranlassen
unilateral	einseitige
chancellor	merkel
snacks	snacks
calculation	berechnung
chip	platzieren
galleries	galerien
in-depth	eingehende
pushed	gedrängt
protects	schützt
tab	register
sharp	deutlichen
exclude	ausschließen
serial	schnittstelle
ceremony	akt
confidential	vertraulich
carriers	fluggesellschaften
verify	überprüfen
secured	gesichert
breaking	brechen
pine	duft
menus	menüs
occasionally	gelegentlich
criterion	kriterium
s.	s.
adjacent	angrenzenden
speaks	spricht
fare	ticket
tension	spannungen
administrator	administration
mar	mar
explorer	explorer
critics	kritiker
await	abwarten
commander	picard
vineyards	weine
birthday	geburtstag
congratulating	gratulieren
waves	wellen
fits	passt
ties	verbindungen
meaningful	sinnvolle
compatibility	kompatibilität
emperor	kaiser
liquid	liquidität
helsinki	helsinki
amid	inmitten
optimised	optimiert
sv	sv
su	su
capitalism	kapitalismus
q	q
baggage	gepäck
shore	ufer
broadcasting	sender
sat	sat-tv
definitions	definitionen
sa	sa
completing	vollendung
privileges	rechten
packed	gefüllt
bathing	baden
shoes	schuhe
distributors	distributoren
deck	sonnenterrasse
gradual	schrittweise
in-house	intern
insight	einblick
wishing	beitreten
canary	kanarischen
interpreted	interpretiert
symbols	symbole
experiments	versuche
motions	entschließungsanträge
keyboard	tastatur
argued	argumentieren
installer	installation
avenue	avenue
haiti	haiti
tendency	tendenz
developer	entwickler
democracies	demokratien
dolomites	dolomiten
somewhere	irgendwo
lo	lo
solving	lösen
air-conditioned	klimaanlage
attraction	attraktiv
differently	unterschiedlich
listing	aufgelistet
orange	orange
suspension	aussetzung
alexander	alexander
alter	verändern
donors	geber
motivated	motiviert
matches	spiele
auto	auto
outlined	dargelegt
nokia	nokia
socially	sozial
perceived	wahrgenommen
thereof	kopien
legendary	legendären
emphasises	unterstreicht
washing	waschmaschine
hairdryer	haartrockner
lifelong	lernen
worlds	welten
execute	auszuführen
tram	haltestelle
reasonably	vernünftig
classified	eingestuft
47	47
rocks	felsen
marvellous	wunderbaren
latvia	lettland
transmitted	übermittelt
warcraft	warcraft
haet	het
exquisite	köstliche
constraints	beschränkungen
consolidate	festigen
reactions	reaktionen
activate	aktivieren
detect	erkennen
privatisation	privatisierung
edinburgh	edinburgh
councils	tagungen
laying	festlegung
globe	weltweit
strip	gaza
700	700
posting	posten
gates	tor
corporations	konzerne
clauses	ziffern
inspections	kontrollen
patch	patch
adequately	hinreichend
85	85
container	container
fundamentally	grundlegend
complimentary	kostenfreien
herself	selber
recognising	anzuerkennen
boutique	boutique
diesel	motoren
secretary-general	generalsekretär
hague	haag
dominated	dominiert
dioxide	co2-emissionen
au	au
inevitably	unweigerlich
perception	wahrnehmung
barrier	hindernis
frank	frank
ipod	ipod
maintains	unterhält
seventh	siebten
quark	quark
oasis	oase
imaging	kameras
backed	gestützt
volumes	volumen
teach	lehren
inevitable	unvermeidlich
resumed	erkläre
integrating	integrieren
retained	beibehalten
1980	1980
hectares	hektar
determining	bestimmung
refugee	flüchtlingen
renewal	erneuerung
modest	geringe
bears	trägt
musicians	musiker
aboard	bord
qualification	qualifikation
avec	avec
croatian	kroatischen
stimulate	anregung
reinforced	verstärkten
exotic	cocktails
bugs	fehlern
consultations	konsultationen
clinical	klinik
variables	variablen
municipality	gemeinde
preservation	bewahrung
echo	echo
sympathy	mitgefühl
featured	vorgestellt
congo	kongo
simplified	vereinfacht
1988	1988
colombia	kolumbien
wasn	dauerte
ironing	bügelservice
xp	xp
noticed	bemerkt
protectionism	protektionismus
sheep	wolf
è	è
sadly	bedauerlicherweise
paint	farbe
gourmet	kulinarischen
automobile	automobilindustrie
5th	5.
engagement	engagements
threatening	drohen
ruins	ruinen
attach	messen
cooling	temperaturen
joseph	joseph
observations	bemerkungen
on-site	hoteleigenen
ð	fur
cabin	befördert
starfleet	uss
shell	`
gear	gang
enhancing	verstärkung
jesus	jesus
montenegro	montenegro
plane	flugzeug
wisdom	weisheit
broadcast	sendung
appreciation	wertschätzung
overwhelming	mehrheit
holder	inhaber
haven	oase
rss	rss
linking	verknüpfen
chef	chef
furnishings	möbeln
optimise	optimieren
isolation	isolation
dans	dans
grey	zellen
textiles	textilien
limiting	begrenzung
titles	titel
marriage	ehe
damaging	schädlich
fruits	früchte
accessed	zugreifen
joy	freude
gps	gps
procedural	verfahrens
supplement	ergänzen
deciding	beschließen
gathering	erfassung
illness	krankheit
correction	korrektur
premier	premier
sad	bedauerlich
tonight	abend
pedestrian	fußgängerzone
comfortably	komfortabel
interventions	interventionen
recover	erholen
organs	organen
seminar	seminar
warsaw	warschau
catholic	papst
traditionally	traditionell
angle	winkel
broadly	weitgehend
studying	studieren
cave	höhlen
elegance	eleganz
oriented	orientiert
lifts	hebt
folk	bulgarischen
forming	bilden
genetically	genetisch
transnational	grenzüberschreitende
korean	korea
hp	hp
surfaces	oberflächen
printer	drucker
qualities	qualitäten
ukrainian	ukrainischen
monastery	kloster
chart	tabelle
architects	architekten
promenade	promenade
exploited	missbraucht
strikes	ausgewogenes
scripts	schriften
assessed	bewertet
festivals	festivals
infrastructures	infrastrukturen
grave	schwerwiegende
zealand	neuseeland
forever	endgültig
episode	vorfall
mineral	rohstoffen
url	url
popularity	beliebt
dumping	entsorgung
missed	versäumt
absurd	absurd
sierra	sierra
mailing	eintragen
responded	reagiert
stones	steine
affair	angelegenheit
analysed	analysiert
09	zuletzt
surplus	überflüssig
hunger	hunger
chances	chancen
queen	königin
accommodations	unterkünften
far-reaching	weitreichende
bookings	buchungen
wanting	wolle
abilities	fähigkeiten
shoe	schuhe
cds	cds
endeavour	bemühen
aggressive	verhält
delivers	liefert
xml	xml
boundaries	grenzen
judges	richter
ha	ha
acquis	gemeinschaftlichen
securing	sicherung
earned	verdient
romanian	rumänischen
writer	schriftsteller
basel	basel
buttons	tasten
entities	einheiten
smallest	kleinste
tape	bürokratie
lodge	lodge
rice	reis
personality	persönlichkeit
continuity	kontinuität
17th	17.
trans-european	transeuropäischen
mixture	mischung
dominant	herrschenden
hiv	hiv
albeit	wenngleich
beat	schlagen
pocket	tasche
remedy	abhilfe
altogether	gänzlich
timing	zeitlichen
wikitravel	wikitravel-benutzer
entity	einheit
banquet	veranstaltungsräume
stroll	spazieren
endless	unzählige
closure	schließung
reveal	offenbart
organ	organ
floods	überschwemmungen
married	ehe
yield	erbringen
worried	beunruhigt
nigeria	nigeria
bag	tasche
safeguarding	wahrung
openly	offen
kill	töten
finishing	fertigstellung
explanations	erklärungen
16th	16.
temporarily	vorübergehend
filters	filter
seas	meere
sensitivity	sensibilität
activists	demonstranten
terrain	terrain
scenes	szenen
detection	nachweis
legacy	erbe
eliminating	beseitigung
cattle	tiere
surgery	operation
arm	arm
2.5	2,5
02	zuletzt
03	zuletzt
wire	kabel
06	zuletzt
inappropriate	angebracht
distinctive	charakteristischen
08	zuletzt
seekers	asyl
mayor	bürgermeister
libraries	bibliotheken
score	punkten
routine	alltag
tens	transeuropäischen
architect	architekten
sorts	sorten
blocked	blockiert
interfaces	schnittstellen
15th	15.
nightlife	nachtleben
solo	solo
seaside	meer
wc	wc
vertical	dynamische
complementary	ergänzen
audiovisual	audiovisuellen
complement	ergänzen
monument	sonstigen
killing	töten
courtyard	innenhof
incident	vorfall
loading	laden
como	como
distinguish	unterscheiden
swift	rasche
ads	anzeigen
commands	befehle
instant	sofortige
thou	bist
optimisation	optimierung
3-star	3-sterne-hotel
demanded	geforderten
deeper	tiefer
stuttgart	stuttgart
nicht	non
iv	iv
workplace	arbeitsplatz
conducting	durchführung
bond	anleihen
safely	sicher
invites	lädt
experimental	versuche
pursuit	verfolgung
skill	fähigkeiten
tone	ton
tunisia	tunesien
continuation	fortsetzung
ca	ca
leipzig	leipzig
pop	auftauchen
exploit	ausbeutung
viruses	viren
towels	handtücher
vessel	schiff
loaded	geladen
belt	band
asks	fragt
incomes	einkommen
tremendous	enorme
solarium	solarium
locally	lokal
oder	or
criticised	kritisiert
tiny	kleinste
immense	gewaltigen
liberals	liberalen
refurbished	renovierten
stadium	stadium
minimise	gering
collections	sammlungen
celebration	feiern
accountability	rechenschaftspflicht
compromises	kompromisse
arises	ergibt
c.	c.
algeria	algerien
attacked	angegriffen
painted	gestrichen
delegations	delegationen
worker	arbeiter
scrutiny	prüfung
nikon	nikon
races	rennen
unified	einheitliches
chile	chile
ours	halb
assessments	bewertungen
voices	stimmen
tries	versucht
divisions	abteilungen
conviction	überzeugung
harder	schwieriger
evaluated	bewertet
promotes	fördert
admire	bewundern
auction	spende
donor	geber
promising	verspricht
medicinal	arzneimittel
margin	spielraum
costly	teuer
doha	doha
demo	demonstration
sincere	aufrichtig
sleeping	schlafen
couples	paare
shame	schande
obstacle	hindernis
gothic	mittelalterliche
beautifully	schön
rid	befreien
disappear	verschwinden
bags	taschen
confirms	bestätigt
inc	inc.
generic	allgemeiner
parish	gemeinde
preparatory	vorbereitungen
radiation	gefährdung
dealer	händler
shorter	kürzen
adverse	negativen
enquiries	anfragen
improves	verbessert
bands	bands
modification	änderung
plates	platten
defines	definiert
mallorca	mallorca
prerequisite	voraussetzung
une	une
noble	ring
fragile	schwachen
currencies	währungen
lawyers	spezialisierte
singapore	singapur
saddam	saddam
posed	gestellte
downloads	downloads
refusal	weigerung
disagree	widersprechen
workforce	arbeitskräfte
outermost	äußerster
kit	set
renaissance	renaissance
viewing	betrachtung
painful	schmerzen
dust	sand
climbing	aufstieg
tracking	verfolgung
tuscany	toskana
scenario	szenario
weapon	waffe
fusion	fusion
1970	1970
46	46
baroque	umgebaut
bottle	shower
trials	prüfungen
hearts	herz
stating	besagt
ambassador	botschafter
stringent	strengere
newest	neueste
ratify	ratifizieren
ceo	ceo
distribute	verteilen
4th	4.
quarters	viertel
macroeconomic	makroökonomischen
batteries	batterien
harmonise	harmonisieren
distant	ferne
actor	schauspieler
abstained	enthalten
coordinating	koordinieren
41	41
prince	johann
captured	gefangen
confidentiality	vertraulichkeit
profitable	gewinn
impetus	impuls
retirement	renten
baths	bäder
chechnya	tschetschenien
readers	leser
admission	zulassung
pillars	säulen
extends	erstreckt
innocent	zivilisten
safeguards	schutzmaßnahmen
struck	erstaunt
warrant	haftbefehl
loan	darlehen
stakeholders	interessengruppen
complaint	beschwerde
marco	marco
municipal	städtische
porto	porto
advances	fortschritten
bid	angebots
advocate	befürworter
sums	summen
masters	meister
pse	pse-fraktion
siemens	siemens
lcd	display
quest	streben
grid	netz
preference	bevorzugt
deployment	einsatzes
invested	investiert
aiming	abzielen
lady	dame
rear	hinten
ruled	regiert
insert	einfügen
check-out	schnelles
capacities	kapazitäten
inviting	einladen
identifying	identifizierung
systematically	systematisch
vibrant	lebendigen
shaped	geprägt
zoom	vergrößern
admitted	zugelassen
annually	jährlich
een	een
sofa	bequemen
archaeological	ruinen
endorsed	gebilligt
attempting	versucht
eec	eg
antique	antiken
gaining	gewinnt
reaches	erreicht
interference	einmischung
jews	juden
sequence	reihenfolge
sends	sendet
kde	kde
consultants	berater
productions	produktionen
palm	english
pricing	preisen
invoice	rechnung
paragraphs	ziffern
critique	kritik
danube	donau
thinks	denkt
enemies	feinde
caribbean	karibik
mood	stimmung
instability	instabilität
broadband	internetzugang
memories	erinnerungen
vacuum	lücke
measurements	messung
mines	salz
seller	verkäufer
repression	unterdrückung
inequality	ungleichheit
discretion	ermessen
economical	ökonomische
carte	carte
limitations	einschränkungen
rank	rang
eating	essen
bold	gedruckt
champion	meister
intimate	gemütlichen
selecting	auszuwählen
journal	zeitschrift
pose	darstellen
terraces	terrassen
restrictive	verbindlichen
offset	ausgeglichen
symbolic	symbol
transported	transportiert
lens	objektiv
pipeline	vorbereitung
monopoly	faktisch
origins	ursprung
tensions	spannungen
universe	universum
disabilities	behinderungen
introduces	eingeführt
dependence	abhängigkeit
ideology	ideologie
carries	birgt
muslims	muslime
genocide	völkermord
guilty	schuldig
accessibility	zugänglichkeit
ideological	ideologie
palma	palma
luck	glück
backup	sicherung
processor	verantwortliche
settlements	siedlungen
lands	böden
protests	proteste
formerly	ehemals
spreading	ausbreitung
skilled	qualifizierte
profession	beruf
indications	anzeichen
magazines	zeitschriften
eine	around
stabilisation	stabilisierung
1990s	90er
jerusalem	jerusalem
springs	quellen
technically	technisch
canal	kanal
existed	bestanden
prestige	prestige
networking	vernetzung
fabric	stoff
yea	ja
spam	spam
stainless	stahl
indispensable	unverzichtbar
altitude	höhe
statutory	gesetzlichen
transform	verwandeln
deadlines	fristen
imperial	kaiser
width	breite
visas	visa
modifications	änderungen
irrespective	unabhängig
valencia	valencia
breeding	pferde
on-line	online
launching	einleitung
tight	engen
allah	allah
energies	energien
attempted	versuchten
hazardous	gefährlicher
dangers	gefahren
delayed	verzögert
landing	landen
hu	hu
boys	jungen
neutral	verhalten
elimination	beseitigung
encourages	ermutigt
overnight	übernachtungen
partially	teilweise
pull	ziehen
responding	reagieren
converter	converter
consist	bestehen
£	pfund
prevents	verhindert
hosting	gastgeber
imbalances	ungleichgewichte
um	mas
samples	muster
unanimous	einstimmig
verification	überprüfung
abuses	missbrauch
reviewed	überprüft
emotional	emotionen
panels	platten
etc.	etc.
blair	blair
horses	pferde
supreme	obersten
gather	sammeln
estonia	estland
minibar	minibar
holes	loch
graphical	grafische
metals	metall
ordering	bestellung
globally	global
imagination	phantasie
consulted	konsultiert
proves	beweist
tasty	köstliche
nero	nero
shooting	fotografieren
girl	mädchen
cotton	baumwolle
incorrect	falsche
spell	zauber
assessing	beurteilung
glacier	eis
na	na
44	44
café	café
43	43
handed	übergeben
envisaged	vorgesehene
forestry	wälder
kirk	kirk
igc	regierungskonferenz
sich	his
evenings	abends
gambling	wetten
coherence	kohärenz
borne	getragen
roll	rollen
immunity	immunität
adjustments	anpassungen
francisco	francisco
brothers	brüder
plate	platte
solana	solana
databases	datenbanken
convincing	überzeugend
diet	ernährung
a.	a.
william	william
adriatic	adria
intent	absicht
validity	gültigkeit
sql	sql
rolling	rollen
acted	gehandelt
desert	wüste
christians	christen
inspiration	inspiration
younger	jüngeren
breaks	verstößt
samsung	samsung
resolving	lösen
pet	tier
portion	anteil
diagnosis	diagnose
colonial	guatemala
biotechnology	biotechnologie
overseas	ausland
deluxe	deluxe
indirectly	indirekt
