slope	steigung
concept	phänomene
forget	vergessen
chinese	traditionelle
gp	gp
hooks	haken
pyridin-3-yl	optional
ectodermal	ektodermale
focus	konzentriert
seals	verschließt
chewable	suspension
freeze-dried	lyophilisierte
2-4	2-4
elution	elution
follow	folgen
alt	alt
alu	alu
assembled	zusammengesetzten
cytokines	cytokine
two-dimensional	zweidimensionalen
klebsiella	klebsiella
atorvastatin	atorvastatin
suicide	transgene
rickettsia	rickettsia
thromboplastin	viiii
ventral	seitenflächen
stably	stabil
disability	behinderung
sulfate	sulfat
presents	präsentiert
admixed	vermischt
tail	fortsatz
concomitantly	gleichzeitiger
lilly	lilly
leukocytes	leukozyten
zidovudine	zidovudin
humerus	humerus
swivel	schwenkachse
woman	frau
shielding	abschirmung
transducers	wandler
orthogonal	orthogonal
obturator	verschluss
stabilized	stabilisierte
fan	ventilator
trough	wanne
dispersions	dispersionen
kappa	11a
drinking	trinkverhalten
wipe	tuch
alkoxycarbonyl	carboxyl
internally	innen
mycosis	mykosen
turns	windungen
ge	ge
resistor	widerstand
-5	-5
item	gegenstands
glucocorticoid	nichtsteroidale
crotch	binde
membered	5-
inclination	neigung
noted	festgestellt
programme	programm
zn	zn
facilitating	erleichterung
lysosomal	lysosomale
10b	10b
pregnancies	schwangeren
repetitive	wiederholte
parvovirus	parvovirus
horn	medialen
270	270
glycoproteins	glycoprotein
functioning	funktionsfähig
leakage	austritt
colic	kolik
errors	stoffwechselstoerung
hormonal	kontrazeptiva
micro-organisms	mikroorganismen
giving	geben
3r	4-fluorphenyl
epilepsies	myoklonische
abn	abnorme
beverage	getränk
crush	quetschverletzung
endothelin	et
micturition	miktion
conduct	leiten
cotransporter	na
neu	neu
waveguide	lichtleiter
bird	aviäres
pneumocystis	pneumocystis
hairy	leukaemische
polarity	polarität
condensed	kondensierte
loose	freier
wrapping	verpackung
here	hier
stearyl	poloxamer
packing	füllmaterial
disaccharide	disaccharid
relaxation	achalasie
mediastinum	mediastinums
diuretics	diuretika
invented	phantasiebezeichnung
patches	pflaster
recessive	mittelmeerfieber
900	900
acrylates	meth
thymidine	pyrimidin
gln	gln
numbness	taubheit
technical	technische
urokinase	urokinase
compliance	übereinstimmung
welded	verschweißt
extreme	extrem
somatic	körperlichen
alkylating	antineoplastische
accomplished	erreicht
supplements	nahrungsergänzungsmittel
diagnosed	diagnostiziert
pick	niemann-pick
symmetrical	symmetrisch
implement	werkzeugs
erythrocytes	erythrozyten
quinoline	pyridin
repressor	eif
granulocyte	granulozyten
haemophilia	hämophilie
macromolecule	makromolekül
mobility	q
marginal	randbereich
330	330
⁸	r⁸
outcomes	endpunkte
utilisation	nutzung
flexibility	flexibilität
unitary	kombinierter
spinocerebellar	spinozerebellare
ache	muskelschmerzen
atrium	vorhof
vertebrae	wirbel
coatings	beschichtungen
cocaine	psychische
tools	instrumente
readily	leicht
standing	stehende
suspensions	suspensionen
convertase	caspase
alkynyl	alkenyl
156	156
membranous	nephritisches
hyperthermia	hyperthermie
cho	-zellen
mutein	mutiertes
chr	chronisches
diaphragmatic	hernie
spike	dorn
thickeners	verdickungsmitteln
helix	wendel
p-450	p-450
fanconi	adultes
tinea	tinea
populations	patientengruppen
becomes	allmählich
company	unternehmen
corrected	korrektur
bodily	körperflüssigkeit
disruption	zerstörung
cellulitis	zellulitis
appendix	fortsatz
rabbit	kaninchen
n-propyl	n-propyl
thuringiensis	thuringiensis
detects	detektiert
organopolysiloxane	organopolysiloxan
1997	1997
1998	1998
latching	verriegeln
mn	mn
oscillator	endogene
erythroid	erythropoetische
hyperkinetic	hyperkinetisches
mu	me
thio	bedeutet
suppository	e1
pivotable	verschwenkbar
liposomal	xanthomatose
acetylcholine	vesikuläre
tap	aspiration
reflector	reflektor
expanding	expansion
adenomatosis	adenomatose
purinergic	purinerge
ornithine	vasopressin
pushed	gedrückt
foods	lebensmitteln
pulling	ziehen
bend	biegung
14a	14a
234	234
scar	hypertrophische
skirt	mantel
232	232
glycosaminoglycan	vernetztes
5.3	5.3
babinski	babinski
expiratory	maximale
baculovirus	baculovirus
hematoma	hämatom
endoscopy	endoskopie
coaxially	koaxial
vital	lebende
dilator	dilatator
leiomyoma	leiomyom
env	gp
significance	bedeutung
iiia	iiia
titre	erhoehter
sio	sio
melanocytic	naevi
mesenchymal	stammzellen
acetonitrile	acetonitril
haematological	hämatologische
fx	fraktur
anaesthetics	anästhetika
148	148
connects	verbindet
icd-o	naevi
polycarbonate	polycarbonat
pigs	schweinen
fe	fe
fits	passt
warm-blooded	warmblütigen
revealed	ergaben
contraindicated	kontraindiziert
varied	variiert
ribozyme	ribozym
branches	schenkel
arthroplasty	arthroplastik
interrupted	unterbrochen
guanosine	gtp
fluticasone	eingeschränkte
accelerated	beschleunigt
correlation	korrelation
sc	sc
benzamide	benzamid
operate	arbeiten
secreting	hypophysenadenom
triggering	auslösen
typical	übliche
wavelengths	wellenlängen
oncology	radiotherapie
breaking	unterbrechen
underside	unterseite
collagenase	metalloproteinase
1-15	15
chondroitin	chondroitinsulfat
contractions	kontraktionen
fasteners	befestigungselemente
vasoactive	intestinales
129	129
braid	205
bubbles	blasen
blocked	blockiert
cll	lymphozytische
solitary	knochenzyste
ready-to-use	gebrauchsfertigen
tsh	tsh
apex	spitze
cd8	008
selenium	selen
stimulated	stimuliert
labor	wehen
gtp	gtp
interleukin-1	interleukin
alkylamino	amino
lp	itte
listing	sequenzprotokoll
orange	oberteil
couplers	kuppler
histological	histologische
relapsed	rezidiv
weber	partieller
mumps	epidemische
nacl	nacl
rapamycin	rapamycin
insemination	insemination
prevented	verhindert
mesothelioma	mesotheliom
leukaemias	leukaemien
emollient	weichmacher
suturing	nahtmaterial
drilling	bohrung
fingerprint	fingers
proteinaceous	fett
formulating	vereinigen
intranasal	intranasale
dielectric	elektrochemische
overlap	überlappen
ethylenically	ethylenisch
assemblies	ventile
obstetric	wehentaetigkeit
charging	beladen
purinoceptor	purinerge
supraventricular	supraventrikuläre
stopped	abgebrochen
anti-microbial	antimikrobielle
maltose	maltose
gender	geschlecht
physiologic	physiologischen
referred	genommen
haemangioma	haemangiom
permeation	beschleunigt
high-frequency	mhz
initiating	einleiten
globe	augapfels
cultivated	kultiviert
spider	naevi
inverted	umgekehrt
soy	hydriertes
fibronectin	wiederholten
literature	literatur
static	statischen
connect	verbinden
entering	eintritt
sexually	sexuell
huntington	chorea
inflated	aufblasen
collector	löchern
deaminase	serin
braided	fäden
vibrio	vibrio
medications	medikamente
infarct	infarkt
fevers	brucellose
restricted	beschränkt
t-cells	t-zellen
washed	gewaschen
inducer	auslöser
participants	teilnehmern
nominal	aphasie
yarns	fäden
lactone	04
viable	lebende
polyurethanes	polyurethanen
catheterisation	katheterisierung
t-butyl	t-butyl
alleviating	linderung
mechanisms	mechanismus
1s	esterase
isotope	isotop
differing	unterschiedlicher
flows	strömt
murmur	herzgeraeusch
cmv	cmv
put	legen
non-specific	nicht-spezifische
e1	e1
asn	asn
software	computer
incorporates	eingebaut
l-lysine	l-lysin
cured	härte
chiral	*
created	geschaffen
chemotactic	chemotactic
compulsive	persönlichkeitsstörung
ketones	keton
stretchable	dehnbaren
agrobacterium	agrobacterium
heartbeat	herzschlag
condom	kondom
xi	xi
possessing	besitzt
xa	xa
aseptic	aseptische
non-volatile	flüchtiges
metabolised	metabolisiert
improvements	verbesserungen
incubated	inkubiert
bordetella	bordetella
4b	4b
sounds	fehlende
174	174
spondylitis	spondylitis
sheep	schaf
little	wenig
008	008
ï	introna
bears	anliegt
0.03	0,03
structured	aufgebaut
1500	1500
traction	ausgeübt
1c	1c
paramagnetic	resonanz
motility	okuläre
endotracheal	tubus
neurotransmitter	vesikuläre
pigmentation	pigmentiert
dyskinesia	dyskinesie
cys	cys
maleate	saurem
guidelines	leitlinien
184	184
releases	freisetzt
tetrahydrofuran	tetrahydrofuran
asymmetric	kohlenstoffatom
capsular	pneumoniae
exactly	genau
opinion	gutachten
insertable	einführbar
erectile	impotenz
alumina	aluminiumoxid
epoetin	epoetin
cartridges	patronen
western	enzephalomyelitis
insuman	insuman
synergistic	synergistische
technic	techniken
hypercholesterolaemia	hypercholesterinämie
knitted	struktur
lamellar	ichthyosis
viscous	viskose
ureteral	harnleiters
vulvar	vulva
breathable	konzentrierte
ophthalmoplegia	ophthalmoplegie
tomographic	pet
shower	shampoo
compensation	genetik
merck	merck
dextrose	dextrose
opens	öffnet
reproduction	is
referral	verfahrens
intra-abdominal	befall
1.4	1,4
fashion	weise
sea	amerikanische
7a	7a
pre-existing	rueck
sac	keimzellen
psychoses	psychosen
peritonitis	peritonitis
epstein-barr	021
pedestrian	fußgänger
recessed	ausgenommen
tanning	künstlichen
hemangioma	haemangiom
resorbable	resorbierbare
igf-i	igf-i
acceleration	beschleunigung
forced	gedrückt
absorber	tritt
implemented	realisiert
para	vorkommt
stromal	endometriales
potato	maisstärke
cava	cava
mix	mischen
cetyl	benzalkoniumchlorid
placebo-controlled	as
analogs	analoge
rider	motorradfahrer
eff	folgeschaden
luciferase	luciferase
venereal	venerische
subtilis	subtilis
sure	sicher
complexed	komplexiert
sulfonate	natriumlaurylsulfat
effecting	bewirken
resulted	führte
falls	fällt
harmful	schädlichen
reticulum	retikulum
site-specific	mutagenese
vaccinia	eingefügt
cloned	wurde
why	warum
refrigerator	kühlschrank
interacting	wechselwirkung
kb	kb
volunteers	probanden
mediastinal	mediastinums
dermatosis	dermatose
lift	hebevorrichtung
clock	rhythmus
detectors	detektoren
dog	hund
tensioning	spannung
postmenopausal	syndroms
mannose	mannose
reflecting	reflektierende
parkinsonism	parkinsonismus
-phenyl	-phenyl
sun	sonnenschutzmittel
formaldehyde	formaldehyd
4-methoxyphenyl	4-methoxyphenyl
d.	d.
12b	12b
docetaxel	docetaxel
agreed	durchzuführen
pichia	pichia
parainfluenza	aviäres
evaporation	verdampfen
aplasia	aplastische
7.0	7,0
spaces	hohlräume
gauge	meßeinrichtung
shoe	bursitis
cyclase	synthase
chicken	aviäres
find	untersuchungsmaterialien
staff	personal
microsphere	mikrokügelchen
grafted	maleinsäureanhydrid
dividing	trennwand
true	echte
varicella	encephalitis
operational	operativen
potentials	potentiale
wood	methanol
carboxylate	carboxyl
rich	fibrosierende
stain	fleck
he	er
resp	atmungsorgane
thienyl	thienyl
bifunctional	isomerase
oligosaccharides	oligosacchariden
sulfonic	aryl-
stasis	varizen
freezing	lagern
dc	erwähnten
haemostatic	blutgerinnung
herbal	pflanzliche
ones	ausgewählter
enteral	enterale
adhered	haftet
guanidine	umsetzt
du	ni
dr	dr
peptidase	sekretorische
oxy	methylen
transitional	uebergangszellkarzinom
intensive	pädiatrische
colloid	099m
transferrin	bakterieller
saliva	speichel
morning	krankheitszustand
-transporting	transport
410	410
erythromycin	erythromycin
recommendations	empfehlungen
catch	sperre
3d	021
xiii	xiii
hinged	angelenkt
looks	aussieht
above-mentioned	vorgenannte
corticosteroid	dehydrogenase
art	technik
aspect	innerer
aphthous	stomatitis
potent	starker
professional	personal
angioedema	angioödem
microcapsule	mikrokapsel
eliminating	beseitigung
cattle	rind
hypodermic	subkutane
nocturnal	enuresis
optimum	optimale
project	vorsteht
centrifugation	zentrifugation
subtilisin	subtilisin
ankylosing	ankylosans
reperfusion	myokardiale
teva	teva
coordination	koordination
unable	unfruchtbarkeit
routine	fort
crude	ausgeht
occupational	industrie
tocopherol	tocopherol
approach	ansatz
ruptured	ruptur
360	360
grafting	verpflanzung
europe	europe
notice	bemerken
recently	kurzem
exam	gesichert
purity	reinheit
confusion	verwirrtheit
ribonucleic	rna
planes	ebenen
foetus	fetus
carbamoyl	mangel
contamination	verunreinigungen
come	kommen
retinol	retinol
chlorhexidine	chlorhexidin
sputum	sputum
freely	frei
eyeball	augapfels
ramp	geneigte
arrhythmias	arrhythmien
metered	inhalationsgerät
layered	beschichteten
figures	figuren
technics	techniken
progeny	nachkommen
delirium	alkohol-
col	personenkraftwagen
comes	kommt
detailed	genaue
leishmaniasis	leishmaniase
tone	muskeltonus
sealant	füllung
boron	reduktionsmittel
cystitis	zystitis
community	wissenschaftlichen
batch	verantwortlich
vena	vena
stretched	gestreckten
learning	transfer
pericardial	haemorrhagisch
withdrawn	zurückgezogen
cu	cu
154	154
pr	el
8.0	8,0
recognises	erkennt
toothpaste	zahnpasta
locally	lokal
humectant	feuchthaltemittel
mark	markierung
outflow	ausfluss
slowly	langsam
pg	pg
ireland	ireland
dup	verhaltens
slits	schlitzen
bellows	herum
osteogenic	osteosarkom
po	po
empty	entleerung
cyclist	fahrrades
6b	6b
congenita	congenita
cyclin-dependent	016
concerning	betreffen
polyposis	polyposis
myelosis	myelose
leukoplakia	leukoplakie
anti-tumour	antitumormittel
uns	bezeichneter
resorption	resorption
bulbar	spezifiziert
allele	diagnostiziert
c3	komplement
166	166
denote	bedeuten
spin	spina
p2	p2
atmospheric	gesetzt
comparator	ebenso
extruded	extrusion
ejection	abgabevorrichtung
connectors	verbinder
emotional	emotionale
lesser	geringeren
lichen	lichen
leprosy	lepra
behavior	verhalten
stopping	abbrechen
hdl	hdl
p.	p.
terephthalate	polyethylenterephthalat
collimator	strahlentherapie
pneumococcal	pneumoniae
motif	chemokin
hydrolysable	vivo
topoisomerase	rekombination
almost	fast
soil	bodens
perineal	dammriss
palmitate	10,0
anode	elektrolyt
pathology	pathologie
ig	immunglobuline
bags	taschen
damaged	defekt
bottles	flaschen
lacking	fehlt
parotid	boesartiger
suggest	legen
granted	europäische
solubilising	lösungsvermittler
preferentially	bevorzugter
anthracycline	antitumormittel
shorter	kürzer
fatal	ausgang
compact	dichten
potentially	möglicherweise
phenotype	verleiht
tartrate	saurem
grain	korngröße
venom	gebundenes
fill	füllen
lacks	fehlt
difficult	schwer
visually	visuell
attenuation	koagulation
moniliasis	moniliasis
sickness	trypanosomiasis
syn	nephritisches
phe	phe
suppurative	eitrige
4.6	4.6
portal	shunt
polyacrylate	polyacrylat
dust	immuntherapie
superoxide	enzymatische
calcification	nebennieren
discoloration	fleck
destruction	zerstörung
inactivating	inaktivierung
constriction	verengung
cholinergic	urtikaria
detergents	wasch-
drip	ausfluss
natriuretic	atriale
stents	stents
sphincter	unterer
extensible	dehnbare
chemistry	phänomen
cytosine	cytosin
drawing	ziehen
diastereoisomers	diastereoisomere
-amino	2-hydroxyethyl
pollen	pollen
manifold	verteiler
just	gerade
benzo	07
proximity	nähe
peritoneum	peritoneums
218	218
resiliently	elastisch
clot	blutgerinnung
atomic	mikroskopie
abrasion	dentale
ad	senile
glue	kleber
yet	dennoch
brachial	plexus
weekly	wöchentlich
adv	zwischenfaellen
rotavirus	gastroenteritis
buffering	puffer
calmodulin	kalzium-kalmodulin-abhängige
dissociation	atrioventrikulaere
adp	kreatinkinase
swallowing	schlucken
acetylsalicylic	acetylsalicylsäure
irradiated	bestrahlt
character	eigenschaft
add	geben
valid	unternehmen
intraluminal	auskleidung
requiring	erfordern
snap	greifen
280	280
slidable	verschiebbaren
spasms	spasmen
taxane	taxan
adh	adh-sekretion
psi	psi
11a	11a
synthesising	synthetisieren
phosphatidyl	phosphatidylcholin
showing	dammriss
vagus	vagus
chitin	chitin
monosaccharide	monosaccharid
serotype	serotyp
260	260
deployment	einsatzes
world	leishmaniase
unique	einmaligen
cyclopropyl	cyclopropyl
preventive	therapeutikum
modifications	modifikationen
frontal	sinus
alternatively	alternativ
modulated	moduliert
glove	handschuh
parasite	parasiten
flux	fluss
isotonic	kochsalzlösung
malnutrition	mangelernaehrung
night	enuresis
rearrangement	lymphozyten
gm2	gm
3s	spinozerebellare
interconnecting	verbindenden
164	164
retractable	zurückgezogen
stereoisomers	stereoisomere
functionalized	präparats
disord	persönlichkeit
cathode	fließen
japanese	encephalitis
straight-chain	geradkettiges
117	117
diclofenac	diclofenac
b2	b2
betaine	amphotere
119	119
psychogenic	gilles
o-	o-
immunoreactive	immunreaktion
trace	geringen
pyrrolidine	derivate
broad	breiten
decision	entscheidung
integration	integration
protocol	sequenzprotokoll
endotoxin	extrakorporale
voice	sprache
g-csf	g-csf
screwed	schrauben
knife	biopsie
dissociative	dissoziative
ptfe	ptfe
run	verlaufen
airways	luftwege
302	302
dissection	radikale
multivalent	mehrwertige
bolt	bolzen
1,2-a	4-methylphenyl
toluene	toluol
isocyanate	umgesetzt
radiography	röntgen
boiling	kohlenwasserstoff
enbrel	enbrel
smear	abnormer
industry	industrie
discussed	diskutiert
polyacrylamide	polyacrylamid
preset	vorgegebene
extensions	erweiterung
isoleucine	isoleucin
luer	dorn
establishing	festlegen
abscesses	abszess
os	os
diisocyanate	04
n-oxide	n-oxide
sintered	gefertigt
ridges	stege
facility	anlage
wasting	hiv-
spreading	verteilen
lhrh	lhrh
finely	fein
encapsulating	eingekapselt
wrap	tuch
proportional	proportional
nurs	krankenpflege-
substitutions	substitutionen
anorexia	anorexie
het	het
terminated	beendet
salicylate	vergiftung
oc	dreiraedrigen
..	..
bristles	borsten
bores	bohrungen
spots	flecken
hepatocyte	il-6
tyr	tyr
patella	patella
duodenum	duodeni
specimens	untersuchungsmaterialien
enzymatically	enzymatisch
sequelae	folgen
tight	dichten
ligation	haemorrhoiden
hr	stunde
triangular	os
lumens	hohlräume
illuminating	beleuchtung
incorporation	einbau
glucan	lysosomale
protrusions	vorsprüngen
224	224
colourants	farbstoffen
222	222
raising	hervorrufen
strabismus	strabismus
compositae	verbundwerkstoff
upwardly	oben
abducens	sechsten
casein	protein-kinase
milligrams	milligramm
dyspnoea	dyspnoe
stapling	klammern
induces	induziert
doxorubicin	doxorubicin
n-terminus	n-terminus
pineal	corpus
hypoglossal	hypoglossus
aspirin	aspirin
autologous	transplantate
malic	äpfelsäure
originating	ursprung
toilet	hilfsmittel
rabbits	kaninchen
magnets	magneten
resting	anliegt
universal	allgemeine
sectional	querschnittsfläche
pig	schwein
flanking	005
engineering	gentechnisch
warning	warnhinweise
au	ge
melatonin	melatonin
hospitals	krankenhäuser
tenofovir	emtricitabin
phantom	modells
carboxypeptidase	143
avoided	vermieden
polyvalent	mehrwertige
vulgaris	vulgaris
inactivation	inaktivierung
analgesics	analgetika
cramp	krampf
folic	infolge
hlb	hlb-wert
igf	igf
tin	zinn
terminating	endet
coded	kodierten
weights	geburtsgewicht
igm	igm
smell	geruch
-6-	-6-
orodispersible	schmelztabletten
picture	abbildung
transfection	transfektion
tert-butyl	-butyl
constructs	gegenstände
il-6	il-6
histocompatibility	hla
mitogen-activated	mitogen-aktivierte
restoration	wiederherstellung
pumps	pumpen
coiled	gewickelten
elastase	neutrophile
erbb	erbb
rolling	rollen
homolog	homolog
signalling	anzuzeigen
legal	legal
building	aufbau
henoch	anaphylaktoide
t-lymphotropic	t-lymphotropes
n.	n.
porphyria	porphyrie
complicating	ursache
vegf	vegf
lowered	gesenkt
diffraction	charakteristische
4s	ataxie
indirectly	indirekt
urethane	hydrophob
aerobic	aeroben
levodopa	levodopa
inhibited	inhibiert
2006	2006
2007	2007
muscarinic	m1
recognising	erkennen
palladium	palladium
2008	2008
accidents	unfall
temporarily	vorübergehend
apertured	versehene
others	anderem
geographic	exfoliativa
