en	de
secondly	zweitens
schengen	schengen
limited	begrenzte
child	kindes
desirable	wünschenswert
yellow	orange
four	vier
facilities	einrichtungen
protest	protest
woods	wäldern
sleep	schlafen
asian	asiatischen
controversial	umstritten
consists	besteht
oldest	ältesten
integrity	integrität
pack	pack
exhibitions	ausstellungen
relationships	beziehungen
whose	deren
votes	votes
granting	gewährung
auf	qui
electricity	strom
crises	krisen
poorest	ärmsten
pensions	renten
james	james
presents	präsentiert
neighbours	nachbarn
bike	bike
voted	gestimmt
whatsoever	keinerlei
under	under
teaching	lehre
sorry	leid
pride	stolz
worth	lohnt
carried	durchgeführt
pact	pakt
updated	aktualisiert
point	point
risk	risiko
dynamic	dynamischen
desired	gewünschte
regional	regionaler
railways	eisenbahn
handling	handhabung
every	jedes
updates	updates
suggests	deutet
reforms	reformen
affect	beeinträchtigen
simplify	vereinfachen
bringing	annäherung
encounter	begegnung
alpine	alpen
tickets	eintrittskarten
school	school
prize	preises
crops	kulturen
supports	unterstützt
companies	firmen
wednesday	mittwoch
viable	funktionierende
tools	werkzeuge
convenience	komfort
suite	suite
enhance	verbessern
nine	neun
settings	einstellungen
endorse	billigen
hostels	hostels
enjoy	geniessen
achievements	errungenschaften
charter	charta
bill	bill
force	force
leaders	führer
supervisory	aufsichtsrat
phones	handy
consistent	konsequente
guidelines	leitlinien
estimates	schätzungen
direct	direkte
budget	haushaltsplan
elegant	eleganten
likely	wahrscheinlich
street	street
available	verfügbaren
estimated	geschätzt
colourful	farben
machines	maschinen
blue	blue
established	etabliert
errors	fehlern
preferences	einstellungen
pace	tempo
cyprus	zypern
exactly	exakt
selected	ausgewählten
contributed	beigetragen
corporation	corporation
supplied	gelieferten
lights	beleuchtung
largescale	umfangreichen
drug	drogen
above	oberhalb
conduct	verhaltenskodex
supplier	lieferant
churches	kirchen
tips	tipps
increasing	zunehmende
ever	jemals
consisting	bestehend
seeks	strebt
told	erzählt
specialist	spezialist
simultaneously	gleichzeitig
incentives	anreize
never	niemals
here	hierher
hundreds	hunderte
met	trafen
protection	schutzes
china	china
governing	regieren
represented	repräsentiert
path	pfad
100	100
referring	beziehe
obtained	erlangt
substance	substanz
daughter	tochter
forum	forum
luggage	gepäckraum
items	gegenstände
employees	angestellten
changed	verändert
vicepresident	vizepräsidentin
completely	komplett
reports	berichte
museums	museen
credit	credit
launched	gestartet
permit	erlaubnis
military	militärische
adopting	erlass
suitable	geeigneten
changes	veränderungen
cancellation	stornierung
criticism	kritik
golden	golden
fantastic	fantastische
plays	spielt
besides	neben
campaign	kampagne
mobility	mobilität
explained	erläutert
continue	fortsetzen
natural	natürlichen
replace	ersetzen
brought	brachten
visible	sichtbar
busses	busse
moral	moralische
guests	gäste
actions	aktionen
total	komplettpreise
forums	foren
landscape	landschaft
charge	aufpreis
spoke	sprach
would	würde
army	armee
4star	sternen
hospital	krankenhaus
century	jahrhunderts
arms	waffen
call	call
therefore	daher
m2	m2
strike	ausgewogenes
survive	überleben
type	typ
until	bis
1000	1000
separated	getrennt
holy	heilige
relax	entspannen
successful	erfolgreiches
brings	bringt
slopes	pisten
wars	kriege
award	award
aware	bewusst
99	99
phone	mobiltelefon
berlin	berlin
warm	warmen
adult	erwachsenen
excellent	ausgezeichneten
90	90
hold	abzuhalten
95	95
97	96
circumstances	umstände
1991	1991
1990	1990
1993	1993
1992	1992
word	word
1994	1994
1997	1997
1996	1996
pursue	verfolgen
1998	1998
setup	einrichten
work	arbeit
roof	dach
movies	filme
era	ära
ms	ms
mr	herr
exceptions	ausnahmen
experts	experten
revenues	einnahmen
root	wurzeln
example	beispiel
transition	übergang
indicated	angegeben
give	geben
household	haushalte
india	indien
subsidiarity	subsidiarität
interinstitutional	interinstitutionellen
involve	einbeziehen
indicates	deutet
foods	lebensmittel
want	willst
also	ebenfalls
appointment	ernennung
david	david
attract	attraktiv
rescue	rettung
autonomy	autonomie
end	ende
recovery	erholung
turn	biegen
enquiry	untersuchung
mouse	maus
travel	travel
sitting	sitzung
damage	schäden
machine	maschine
very	sehr
grammatically	grammatisch
significance	bedeutung
boats	boote
gate	tor
ordinary	gewöhnlichen
beach	strand
gaming	casinos
poker	poker
rise	aufstieg
minority	minderheit
beauty	schönheit
after	nachdem
hong	hong
demanding	anspruchsvollen
customs	zollunion
barriers	hindernisse
wrong	falsch
considers	erachtet
lay	grundstein
involvement	einbeziehung
brands	marken
president	präsident
law	gesetz
parallel	parallel
types	typen
las	las
purchase	kauf
attempt	versuch
splendid	herrlichen
third	dritten
vegetables	gemüse
appreciate	schätzen
headquarters	hauptsitz
patent	patent
complexity	komplexität
maintain	aufrechtzuerhalten
green	green
ultimate	endgültige
enter	eingeben
worst	schlimmste
preventive	prävention
democratic	demokratische
order	reihenfolge
wind	wind
wine	wein
operations	operationen
blind	verschließen
executed	ausgeführt
interpretation	interpretation
feedback	feedback
office	office
welcomed	begrüßt
consent	einwilligung
over	laufe
fall	fallen
vary	variieren
satisfied	zufrieden
jacuzzi	whirlpool
london	london
innovative	innovative
saving	rettung
junior	junior
before	bevor
heritage	erbes
fit	fit
imf	iwf
personal	personenbezogener
highlights	highlights
fix	beheben
striking	bemerkenswert
expectations	erwartungen
comprises	umfasst
crew	crew
destroyed	zerstört
production	produktion
vast	riesige
400	400
hidden	versteckt
easier	leichter
overcome	überwinden
damages	schäden
eventually	letztlich
them	zugriffe
belarus	belarus
affected	betroffen
diseases	krankheiten
combination	kombination
prevented	verhindert
similar	ähnlichen
unemployed	arbeitslosen
safe	safe
break	brechen
band	band
therapy	therapie
effects	effekte
they	sie
schools	schulen
yourself	gönnen
tourism	fremdenverkehr
silver	silber
bank	bank
competitiveness	wettbewerbsfähigkeit
represents	repräsentiert
netherlands	niederlanden
meat	fleisch
bosnia	bosnien
circuit	strecke
notified	benachrichtigt
arrested	verhaftet
l	l
asia	asien
skills	fähigkeiten
filling	ausfüllen
component	komponente
victory	sieg
reasonable	vernünftigen
fitness	fitness
nonetheless	nichtsdestotrotz
americans	amerikanern
went	gingen
entitled	berechtigt
meal	mahlzeiten
lasting	dauerhaften
signing	unterzeichnung
schemes	systeme
financial	finanziellen
suspended	unterbrochen
fairly	fair
series	serie
train	zug
crimes	verbrechen
principles	prinzipien
solution	lösung
carry	durchzuführen
milan	mailand
taught	unterrichtet
trading	handelspartner
combining	kombinieren
substantially	beträchtlich
laboratory	labor
saturday	samstag
hostel	herberge
network	netzwerk
driving	motor
restricted	eingeschränkt
cameras	kameras
crucial	entscheidender
vessels	schiffe
tomorrow	morgigen
content	content
re	erstklassige
encourage	ermutigen
piece	stück
millennium	schwelle
adapt	anzupassen
enable	javascript
reader	reader
medicine	medizin
surprise	überraschung
newly	neu
ro	ro
forth	usw.
independence	unabhängigkeit
foundation	foundation
inhabitants	einwohnern
turning	drehen
assured	versichert
rail	schiene
threatened	bedroht
little	wenig
free	kostenlose
yesterday	gestern
campaigns	kampagnen
confirmed	bestätigte
disputes	streitigkeiten
formation	bildung
evil	böse
checked	überprüft
wanted	wollten
certified	zertifiziert
enormous	enormen
created	geschaffen
starts	startet
messages	botschaften
days	tagen
priorities	prioritäten
ist	perfect
creates	schafft
000	000
oppose	ablehnen
isn	wahr
incorporated	eingebaut
signature	unterschrift
baltic	baltischen
clothes	kleidung
onto	biegen
user	user
awarded	verliehen
industrial	industriellen
features	features
attractions	attraktionen
december	dezember
encouraging	ermutigt
hearing	anhörung
channels	kanäle
floors	etagen
adopted	angenommenen
another	weiteres
bicycle	fahrrad
difficulty	schwierigkeit
clarity	klarheit
electronic	elektronischen
42	42
specially	eigens
he	er
renovated	renovierte
strasbourg	straßburg
similarly	ähnlicher
top	top
à	à
girls	mädchen
elevator	aufzug
needed	gebraucht
compromise	kompromiss
listed	aufgezahlt
draft	entwurfs
percentage	prozentsatz
john	john
dogs	hunde
listen	zuhören
manufacture	herstellung
urban	städtischen
ceiling	obergrenze
murder	mord
asset	vermögenswerte
geneva	genfer
mechanism	mechanismus
tool	werkzeug
villages	dörfern
serve	dienen
took	dauerte
rejected	abgelehnt
japanese	japanische
western	westliche
somewhat	irgendwie
shortly	kürze
artistic	künstlerischen
character	charakter
begins	beginnt
distance	distanz
trek	trek
target	zielgruppe
roles	rollen
surrounding	umliegenden
participated	teilgenommen
immigrants	einwanderern
enabled	aktiviert
rate	rate
nations	nationen
preparation	vorbereitung
matter	angelegenheit
classes	klassen
speaking	redezeit
iron	metall
feeling	gefühl
powers	befugnisse
acquisition	erwerb
perspective	vorausschau
bridge	brücke
fashion	mode
sees	sieht
willingness	bereitschaft
respecting	respektieren
modern	modernen
mind	verstand
spectrum	spektrum
glass	glas
raw	rohstoffen
graphics	grafiken
manner	weise
seen	gesehen
seem	scheinen
regulate	regulieren
seek	anstreben
tells	erzählt
contents	inhalte
relatively	relativ
forced	gezwungen
abroad	ausland
strength	stärke
genuine	echten
mostly	zumeist
concrete	konkrete
thoroughly	gründlich
latter	letztere
cope	bewältigen
snow	schnee
thorough	gründliche
situated	situated
sound	sound
recommended	empfohlen
subjects	themen
luxury	luxus
doors	türen
paris	paris
effectiveness	effektivität
taxation	besteuerung
nordic	nordischen
even	sogar
acquire	erwerben
roumania	rumänien
though	obwohl
centres	zentren
codecision	mitentscheidung
extending	ausweitung
involving	einbeziehung
mouth	mund
plenty	reichlich
entry	eintrag
phase	phase
bse	bse
maria	maria
camps	lagern
don	don
observation	beobachtung
medical	medizinischen
partition	partition
flow	fließen
rotary	rotary
treaty	vertrags
competitors	konkurrenten
points	punkte
principle	grundsatzes
enterprise	enterprise
voting	qualifizierter
consumer	verbraucherschutz
notion	vorstellung
fitted	ausgerüstet
reserve	reserve
saying	sage
amending	änderung
reductions	kürzungen
visitor	besucher
meetings	sitzungen
jurisdiction	rechtsprechung
ending	beendigung
treaties	verträgen
attempts	versuche
radio	radio
solutions	lösungen
participate	teilzunehmen
hungary	ungarn
intergovernmental	regierungskonferenz
lessons	lehren
execution	ausführung
busy	beschäftigt
layout	layout
proposed	vorgeschlagene
spite	trotz
implementation	implementierung
situations	situationen
explain	erläutern
unemployment	arbeitslosigkeit
sugar	zucker
theme	themas
rich	reiche
pursuing	verfolgung
integrate	integrieren
announce	mitteilen
folder	ordner
do	tun
exports	exporte
reconstruction	wiederaufbau
professionals	profis
de	de
stop	aufhören
television	fernsehen
preferred	bevorzugte
coast	küste
h	h
supplies	lieferungen
report	bericht
du	du
dr	dr.
net	netz
comply	einhalten
societies	gesellschaften
hall	hall
runs	läuft
contributes	beiträgt
bar	bar
17	17
greens	grünen
countries	länder
fields	felder
16	16
bay	bay
emu	wwu
twice	zweimal
bad	schlechte
architecture	architektur
carrier	fluggesellschaft
release	freilassung
automatic	automatischen
steam	dampfbad
urgency	dringlichkeit
secretary	generalsekretär
respond	reagieren
ethical	ethische
mandatory	obligatorische
disaster	katastrophe
fair	fairen
unanimously	einstimmig
testing	testen
observed	beobachtet
checks	kontrollen
depends	abhängt
decided	beschloss
result	resultat
fail	scheitern
christian	christlichen
optimum	optimalen
taiwan	taiwan
best	beste
techniques	techniken
brazil	brasilien
00	10:00
01	zuletzt
capacity	kapazität
07	10:00
ambitions	ambitionen
lots	menge
rare	seltene
away	away
patients	patienten
artificial	künstliche
continually	kontinuierlich
catalogue	katalog
unable	imstande
cooperation	kooperation
hopefully	hoffentlich
drawn	ausgearbeitet
tolerance	toleranz
discovery	entdeckung
preserve	bewahren
discipline	disziplin
reiterate	bekräftigen
men	männer
terms	nutzungsbedingungen
extend	auszudehnen
nature	natur
confusion	verwirrung
weak	schwach
however	jedoch
religious	religiösen
ltd	ltd.
rivers	flüsse
wear	tragen
extent	inwieweit
news	news
packages	pakete
rapporteur	berichterstatterin
wto	wto
suggested	schlug
received	erhielten
essentially	wesentlichen
accident	unfall
accused	verdacht
reported	berichtete
country	land
uncertainty	unsicherheit
heating	heizung
against	gegen
participating	teilnehmenden
players	spielern
else	sonst
und	hochschule
planned	geplante
receives	erhält
faces	konfrontiert
studio	studio
contribution	beitrag
argue	argumentieren
adapted	angepasst
asked	fragte
con	con
negotiation	verhandlung
prospect	aussicht
tough	harte
seriously	ernst
appeared	erschien
royal	royal
excess	übermäßige
2nd	2.
gap	lücke
active	aktive
denmark	dänemark
initiative	initiative
wider	breiter
250	250
trust	vertrauens
telecommunications	telekommunikation
bureaucratic	bürokratischen
speak	sprechen
conference	konferenz
signals	signale
bathroom	badezimmer
iraq	irak
recognises	anerkennt
engines	motoren
basis	grundlage
union	union
simplification	vereinfachung
condemned	verurteilt
three	drei
been	gewesen
quickly	rasch
commission	kommission
beer	bier
much	wieviel
interest	interesses
basic	basic
expected	erwarteten
flexible	flexiblen
entered	eingegeben
lovely	hübschen
pro	pro
duties	zölle
location	standort
website	website
dry	chemische
life	life
families	familien
relaxing	erholsamen
eastern	östlichen
drugs	drogen
quantities	mengen
concerning	betreffend
prison	gefängnis
search	search
enterprises	mittlere
coherent	kohärenz
lift	lift
personally	persönlich
catch	fangen
aviation	luftfahrt
worked	zusammengearbeitet
crossing	kreuzung
33	33
applied	angewendet
commerce	industrie-
exception	ausnahme
east	osten
presidency	präsidentschaft
gnu	gnu
economies	volkswirtschaften
air	luft
aim	ziel
near	naher
teachers	lehrer
applies	gilt
aid	beihilfen
balance	balance
study	studie
procedure	verfahrens
mistake	fehler
representing	repräsentieren
seven	sieben
economics	ökonomie
played	gespielt
ip	ip
is	ist
accessories	zubehör
ambition	ambitionen
expenses	ausgaben
ii	ii
player	player
im	fit
il	il
in	in
happening	geschieht
ie	explorer
id	id
if	falls
grown	gewachsen
containing	eindämmung
emergency	dringenden
perform	ausführen
suggest	deiner
make	make
demands	forderungen
airport	flughafens
clearly	eindeutig
beside	neben
complex	komplexen
potentially	potenziell
harmony	harmonie
unfortunate	bedauerlich
big	big
success	erfolg
several	mehrere
showing	zeigten
european	europäische
wheel	rad
independent	unabhängige
satellite	sat-tv
social	sozialen
qualifications	qualifikationen
speakers	rednern
rain	regen
hand	hand
liberties	bürgerliche
slovenia	slowenien
documents	dokumenten
portal	portal
ownership	eigentum
investments	investitionen
opportunity	gelegenheit
thoughts	gedanken
cycle	fahrrad
kept	aufbewahrt
piazza	piazza
programs	programmen
los	los
settled	nieder
failing	versagt
boxes	felder
ocean	ozean
academic	akademischen
savings	einsparungen
rome	rom
logo	logo
greatest	größtmögliche
mother	mutter
claims	behauptungen
the	desto
800	800
corporate	corporate
musical	musikalische
left	linke
opinions	meinungen
co2	co2
protocol	protokolls
traditions	traditionen
just	soeben
sentence	satz
photo	photo
sporting	sportlichen
unfair	fair
ideas	ideen
assigned	zugewiesen
proposes	schlägt
via	via
identify	identifizieren
purchasing	einkauf
human	menschliche
facts	fakten
yes	ja
yet	dennoch
previous	vorhergehenden
humanitarian	humanitärer
adding	hinzufügen
unique	einzigartiges
monitored	überwacht
hills	hügeln
candidate	kandidat
dining	salle
ease	erleichtern
had	gehabt
ideal	idealen
spread	ausbreitung
transformed	umgewandelt
board	board
easy	easy
technological	technologische
outset	vornherein
save	sparen
hat	red
humanity	menschlichkeit
gave	gaben
book	buches
21st	21.
survival	überleben
programmes	programmen
possible	möglich
arab	arabischen
possibly	möglicherweise
cultural	kulturellen
suffering	leid
birth	geburt
destroy	zerstören
judge	richter
farms	betriebe
shadow	schattenberichterstattern
hamas	hamas
advanced	advanced
apart	abgesehen
desire	wunsch
dignity	menschenwürde
populations	bevölkerungsgruppen
gift	geschenk
55	55
performing	durchführung
manual	handbuch
unnecessary	unnötige
competence	kompetenz
securities	aktien
remind	erinnern
steps	schritte
officer	ceo
arbitrary	beliebigen
security	security
accuracy	genauigkeit
signal	signal
portuguese	portugiesische
beneficial	vorteilhaft
right	richtige
conciliation	vermittlungsverfahren
deal	umzugehen
people	volk
czech	tschechische
successfully	erfolgreich
elderly	ältere
50	50
born	geboren
clubs	clubs
meters	metern
election	wahlkampf
specialities	spezialitäten
dear	lieber
multiple	mehrere
indirect	indirekten
congratulate	gratuliere
for	für
bottom	unteren
establish	etablieren
normal	normalen
months	monate
ice	eis
creative	kreative
contributing	beizutragen
everything	alles
asking	bittet
unit	einheit
denied	verweigert
offices	büros
christmas	weihnachten
participation	beteiligung
core	kern
package	pakets
forces	kräfte
energy	energie-
deleted	gelöscht
marketing	marketing
night	übernachtung
conventional	konventionellen
constructive	konstruktiven
discount	rabatt
restructuring	umstrukturierung
paid	gezahlt
architectural	architektur
losing	verlieren
post	post
manufacturing	fertigung
super	super
properties	eigenschaften
takes	dauert
chapter	kapitel
install	installieren
increasingly	zunehmend
attacks	anschläge
newspapers	zeitungen
palestinian	palästinensischen
accepts	akzeptiert
o	o
essential	unerlässlich
dinner	abendessen
ensure	sicherzustellen
afternoon	nachmittag
islands	inseln
efforts	bemühungen
palestinians	palästinensern
slightly	leicht
doctor	arzt
automatically	automatisch
match	übereinstimmen
considerations	erwägungen
raised	aufgeworfen
contains	enthalt
statements	erklärungen
presence	präsenz
civil	bürgerlichen
pays	zahlt
prisoners	gefangene
obtaining	beschaffung
sol	sol
intellectual	geistigen
son	sohn
down	down
lies	liegt
beings	menschenhandel
raises	wirft
coastal	küsten
balanced	ausgewogenen
amsterdam	amsterdamer
refined	stilvollen
reducing	verringerung
often	oftmals
rely	verlassen
panorama	panorama
support	unterstütze
initial	ursprünglichen
legislation	gesetzgebung
sovereign	hoheitsgebiet
fight	kampf
accordingly	dementsprechend
fought	gekämpft
editor	editor
way	weise
spring	frühjahr
resulted	führten
music	musik
was	war
war	krieges
happy	glücklich
lowest	niedrigsten
head	kopf
medium	medium
offering	anbietet
offer	anbieten
some	manche
becoming	zunehmend
recommend	empfehle
analyse	analysieren
oil	öl
wireless	wireless
failure	versagen
heat	wärme
hear	höre
dead	tot
solar	sonne
sustained	nachhaltiges
approval	genehmigung
removed	gestrichen
true	wahr
sent	gesendet
congratulations	glückwünsche
versions	versionen
assessment	folgenabschätzung
inside	innen
attached	angeschlossen
maximum	maximalen
devices	geräten
tell	erzählen
budgets	haushaltsausschusses
crystal	unmissverständlich
economic	wirtschaftlichen
stages	phasen
delete	löschen
passenger	personenverkehr
promises	verspricht
adopt	verabschieden
liberal	liberale
puerto	puerto
inclusive	inklusive
request	antrag
tournament	turnier
covers	deckt
evidence	beweise
expertise	fachwissen
promised	versprochen
accounting	entfallen
ship	schiff
20	20
trip	ausflug
negotiations	verhandlungen
physical	physischen
ni	ni
vista	vista
newsletter	newsletter
nl	nl
floor	etage
index	index
whereas	während
stake	spiel
tip	ratschlag
menu	menü
reality	realität
setting	festlegung
role	rolle
holding	abzuhalten
digital	digitalen
test	test
developers	entwickler
operators	betreiber
picture	bild
intend	beabsichtigen
models	modellen
why	warum
felt	spürbar
update	update
fell	fielen
restore	wiederherzustellen
occasion	anlass
variable	variable
discharge	entlastung
weekend	wochenende
died	gestorben
billion	mrd.
faster	schnellere
98	98
assume	gehe
typically	üblicherweise
debian	debian
modules	module
daily	tägliche
beds	zustellbetten
vietnam	vietnam
text	text
reception	rezeption
time	zeit
push	drängen
serious	ernsten
laws	gesetzen
profits	gewinne
songs	lieder
precise	präzise
now	jetzt
concepts	konzepte
managed	verwaltet
0	0
chain	kette
dance	tanz
promoted	gefördert
global	globalen
alternatives	alternativen
focus	fokus
themes	themen
manager	manager
delays	verzögerungen
comments	kommentare
grateful	dankbar
skiing	skifahren
battle	schlacht
chair	vorsitzende
involved	beteiligten
smes	kmu
milk	milch
row	zeile
devoted	gewidmet
venice	venedig
depend	abhängen
zone	zone
flash	flash
father	vater
environment	umwelt
iraqi	irakische
finally	endlich
permanently	permanent
marks	markiert
suffered	erlitten
must	muss
identity	identität
conservation	erhaltung
brown	salz
downloading	herunterladen
reconciliation	versöhnung
string	kette
advantage	vorteil
cheap	billige
confidence	vertrauens
consolidation	konsolidierung
choice	wahl
liability	haftung
anonymous	anonymous
stays	übernachtungen
join	beitreten
trouble	mühe
exact	genauen
minute	minute
governments	regierungen
impressive	beeindruckende
immediately	unverzüglich
level	level
did	wussten
die	sterben
rights	rechte
proposals	vorschlägen
brother	bruder
standards	standards
leave	verlassen
mm	mm
planning	planung
excellence	herausragende
booking	buchung
team	team
quick	schnelle
convince	überzeugen
round	runde
greenhouse	treibhausgasemissionen
upper	oberen
olympic	olympischen
talked	gesprochen
says	sagt
villa	villa
findings	erkenntnisse
be	sein
trend	trend
dealing	umgang
discover	entdecken
literature	literatur
sign	unterzeichnen
cost	kosten
soldiers	soldaten
run	laufen
port	port
cosy	gemütliche
drinks	getränken
presidentinoffice	ratspräsident
cargo	transportiert
adds	fügt
constitution	verfassung
church	kirche
assistance	hilfe
celebrated	gefeiert
remain	verbleiben
shares	aktien
uniform	einheitliche
current	derzeitige
ancient	antiken
goes	hinausgeht
reply	antwort
falling	sinken
appeal	appell
boost	impuls
filled	gefüllt
temperatures	temperaturen
satisfy	befriedigen
drafted	ausgearbeitet
transportation	transport
transparency	transparenz
tibet	tibet
honour	ehre
muslim	muslimischen
french	französische
understanding	verständnis
water	wassers
downloaded	heruntergeladen
upgrade	upgrade
groups	fraktionen
address	adresse
alone	allein
along	entlang
stem	stammzellen
appears	erscheint
change	wandels
wait	abwarten
box	box
sending	versenden
expressly	ausdrücklich
shift	verlagerung
studied	studierte
dublin	dublin
commonly	häufigsten
proud	stolz
exploitation	ausbeutung
trial	gerichtsverfahren
globalisation	globalisierung
suggestion	anregung
usually	gewöhnlich
hospitality	gastfreundschaft
conveniently	günstiger
studies	studien
massage	massage
genuinely	wahrhaft
emerge	auftauchen
breathtaking	atemberaubende
tasks	aufgaben
love	love
raise	anzusprechen
hiking	wandern
extra	zustellbetten
merely	bloß
prefer	bevorzugen
logical	logische
europol	europol
customised	maßgeschneiderte
thumbnail	bild
flexibility	flexibilität
1st	1.
operational	operative
crisis	krise
market	marktes
hotels	hotels
everybody	jedermann
troops	truppen
working	arbeitszeit
roma	roma
sake	willen
positive	positiven
stated	erklärten
visit	besuchen
charles	charles
permitted	zulässig
stored	gespeicherten
territories	besetzten
live	live
wood	holz
iphone	iphone
memory	speicher
films	filme
scope	geltungsbereich
associated	verbundene
today	heutige
introducing	einführung
commissioner	kommissarin
sharing	aufteilung
said	sagte
sessions	sitzungen
clicking	anklicken
flying	fliegen
acceptable	akzeptabel
apparent	ersichtlich
chocolate	schokolade
downtown	innenstadt
employee	angestellten
visual	visual
everywhere	überall
conflicts	konflikte
enthusiasm	begeisterung
olive	olivenöl
cases	fällen
effort	anstrengung
communist	kommunistische
behalf	namen
fly	fliegen
states	staaten
graphic	grafische
sphere	zuständigkeitsbereich
car	autovermietung
originally	ursprünglich
cap	gap
soul	seele
believes	glaubt
reviews	nachfolgend
printing	drucken
values	werten
can	kannst
growing	wachsende
making	entscheidungsfindung
arrive	ankommen
dollars	dollar
claim	behauptung
dedicated	gewidmet
citizens	bürgern
figure	figur
expanding	ausweitung
subsidies	subventionen
sense	sinn
deadline	frist
define	definieren
agent	vermittler
topic	themas
heard	hörte
performed	aufgeführt
council	rat
allowed	zugelassen
spa	spa
referendum	referendum
clothing	kleidung
occur	auftreten
english	englische
swedish	schwedische
conflict	konflikts
productive	produktivität
requirements	anforderungen
winter	winter
fortunately	glücklicherweise
discussion	diskussion
exceptional	außergewöhnlichen
magazine	magazin
chemical	chemischen
till	bis
sunday	sonntag
vital	unerlässlich
pure	reinen
familiar	vertraut
plus	plus
absolute	absoluten
parameter	parameter
economy	volkswirtschaft
map	map
product	produkts
designer	designer
laundry	wäscheservice
information	informations-
may	mai
max	max
dive	tauchen
fed	fed
spot	ort
needs	bedürfnisse
motorway	autobahn
sustainability	nachhaltigkeit
mac	mac
produce	produzieren
designed	entworfen
seeing	beobachten
commit	begehen
date	datum
such	solch
38	38
truly	wahrhaft
revealed	offenbart
grow	wachsen
unity	einheit
man	mann
ombudsman	bürgerbeauftragte
stress	stress
branches	niederlassungen
remember	erinnere
succeeded	gelungen
whenever	wann
maybe	vielleicht
applicant	beitrittskandidaten
explicit	ausdrückliche
st	st
provide	bereitstellen
switch	wechseln
ones	angehörigen
so	sodass
deposit	anzahlung
african	afrikanische
challenge	herausforderung
representation	vertretung
increase	aufstockung
se	se
typical	typische
honourable	verehrten
exclusive	exklusiven
approx	ca.
serving	servieren
furnished	eingerichteten
indeed	tat
pointed	wies
exchanges	austausch
displayed	angezeigt
consulting	consulting
kong	hongkong
stability	stabilität
brain	verstand
stayed	blieben
statistical	statistischen
cuts	kürzungen
november	november
managers	führungskräfte
cold	kalten
still	still
birds	vögel
group	fraktion
monitor	monitor
internationally	international
how	wieviel
interesting	interessante
organisation	organisation
facility	anlage
amazing	erstaunlich
forms	formen
platform	plattform
window	fenster
offers	angebote
spacious	geräumigen
constitutes	ausmacht
policy	politik
mail	mail
main	hauptziel
norway	norwegen
into	inkrafttreten
instantly	sofort
non	non
usa	usa
finance	finanzminister
thereby	wodurch
civilian	zivilbevölkerung
evolution	evolution
introduce	einführen
indigenous	einheimische
lunch	mittag-
qualified	qualifizierte
try	versuchen
half	hälfte
not	nicht
feature	merkmal
thus	somit
bath	bath
provision	bestimmung
widespread	verbreitete
maintaining	aufrechterhaltung
nos	änderungsanträgen
accommodate	untergebracht
term	amtszeit
equality	gleichheit
name	name
opera	opera
january	januar
times	times
didn	wusste
debating	debattieren
establishing	errichtung
possibilities	möglichkeiten
realistic	realistische
stockholm	stockholm
realise	realisieren
rock	rock
ecu	ecu
entirely	gänzlich
quarter	quartal
concerts	konzerte
individually	individuell
el	el
domain	domain
en	en
significantly	bedeutend
mexico	mexiko
badly	schlecht
procurement	beschaffung
eg	eg
revised	überarbeitet
availability	verfügbarkeit
plant	anlage
ec	eg
conventions	übereinkommen
challenges	herausforderungen
involves	einschließt
fires	feuer
owing	aufgrund
organic	ökologischen
begun	begonnen
year	jahres
eu	eu
et	et
happen	passieren
summary	zusammenfassung
disasters	katastrophen
es	drive
intended	gedacht
canada	kanada
living	lebensstandard
ultimately	letztlich
opened	eröffnete
3rd	3.
space	space
profit	profit
furthermore	ferner
factory	fabrik
looking	suchen
contained	enthielt
investigation	untersuchung
unforgettable	unvergesslichen
com	kom
rational	vernünftigen
dutch	niederländische
formula	formel
receiving	erhalt
sensor	misst
correct	korrekten
assurance	versicherung
shows	shows
creating	schaffung
attended	besuchte
theory	theorie
older	älteren
cars	autos
million	mio.
mechanisms	mechanismen
possibility	möglichkeit
quite	ziemlich
advantages	vorteilen
trademarks	warenzeichen
placed	platziert
marina	marina
obligation	verpflichtung
marine	marine
accommodation	unterkünfte
card	card
care	gesundheitsfürsorge
advance	voraus
training	schulung
language	sprache
ministry	dienstes
locations	standorten
discussing	diskutieren
listings	listings
programming	programmierung
british	british
honest	ehrlich
motion	entschließungsantrag
thing	sache
place	place
massive	massive
invitation	einladung
routes	routen
lighting	beleuchtung
promotion	förderung
view	view
think	denke
frequent	häufiger
first	erste
origin	herkunft
cheese	käse
constantly	ständig
rapporteurs	berichterstattern
revenue	einnahmen
spoken	gesprochen
clause	klausel
one	eins
commissioners	kommissare
long	langen
directly	direkt
spanish	spanische
vote	abstimmung
impossible	unmöglich
array	palette
ways	vielerlei
open	offenen
george	george
mix	mix
size	größe
airbus	airbus
city	city
given	anbetracht
necessarily	notwendigerweise
sheet	blatt
silent	stille
district	bezirk
v	v
caught	gefangen
structured	aufgebaut
plastic	kunststoff
anyone	niemandem
indicate	anzugeben
returns	liefert
2	2
tragic	tragischen
convention	konvent
legally	rechtlich
white	white
structures	strukturen
filter	filter
friend	freund
gives	verleiht
bear	zeugnis
exploring	erforschen
mining	abbau
becomes	erlangt
releases	veröffentlichungen
that	dass
season	saison
moscow	moskau
continuous	kontinuierliche
shortcomings	mängel
undertaken	eingegangenen
released	freigegeben
quae	que
specialists	spezialisten
copy	kopie
undoubtedly	zweifellos
appreciated	geschätzt
specify	angeben
population	bevölkerung
11	11
10	10
13	13
12	12
15	15
unfortunately	leider
sailing	segeln
accordance	übereinstimmung
19	19
18	18
require	erfordern
diplomatic	diplomatischen
transferred	übertragen
protected	geschützt
venture	wagen
were	waren
cards	karten
outcome	ausgang
russia	russland
browser	browser
and	und
mountain	berg
addressing	wende
register	registrieren
san	san
investors	investoren
remained	blieb
acknowledged	anerkannt
topics	themen
greece	griechenland
turned	verwandelt
argument	argument
deutsche	deutsche
prestigious	renommierten
say	sagen
rent	vermieten
breakfast	frühstück
occupied	besetzten
any	irgendwelche
invite	einladen
prosperity	wohlstand
conversion	umwandlung
form	form
able	imstande
greek	griechische
efficient	effizienten
plenary	plenarsitzung
manufacturers	herstellern
aside	abgesehen
malta	malta
kilometres	kilometern
note	note
sciences	wissenschaften
emphasis	betonung
18th	18.
take	ergreifen
repeatedly	wiederholt
online	online
interior	interieur
performance	performance
operated	betrieben
encouraged	ermutigt
relaxed	entspannt
channel	kanal
200	200
begin	beginnen
sure	sicher
pain	schmerz
theatre	theater
opposite	gegenteil
track	übersicht
dispute	streit
price	preisstabilität
knew	wusste
clearer	klarer
buffet	buffet
falls	fällt
visitors	besuchern
importantly	wichtiger
printed	gedruckt
sheets	bettwäsche
remarks	bemerkungen
undertakings	zusagen
america	amerika
pages	seiten
authorised	genehmigt
icon	symbol
peninsula	halbinsel
operate	agieren
especially	insbesondere
surprising	überraschend
room	zimmerbeschreibung
considered	because
average	durchschnittlichen
later	später
implications	tragweite
drive	drive
mrs	kollegin
managing	geschäftsführer
trafficking	menschenhandels
nuclear	nukleare
professional	professionelle
senior	führungskräfte
salt	salz
quantity	menge
shop	shop
rating	bewertung
walking	walking
shot	schlag
show	show
german	deutscher
workshops	workshops
pursuant	gemäß
accession	beitritts
representatives	vertretern
discovered	entdeckte
hopes	hofft
bright	helle
spaces	nichtraucherzonen
mountains	berge
threshold	schwelle
corner	ecke
superb	hervorragendes
fifth	fünften
ground	erdgeschoss
colours	farben
slow	langsam
ratio	verhältnis
agreements	vereinbarungen
gulf	golf
title	titel
proportion	anteil
behind	hinter
crime	kriminalität
only	einzige
explicitly	explizit
black	schwarz
equipped	ausgerüstet
wooden	holz
watching	beobachten
awareness	bewusstsein
centrally	zentral
directed	gerichtet
correctly	korrekt
hungarian	ungarische
get	benachrichtigt
contracts	verträge
jazz	jazz
designated	ausgewiesen
employers	arbeitgeber
affecting	beeinträchtigen
cannot	read
negative	negativen
conjunction	verbindung
enjoys	genießt
celebrate	feiern
secondary	zweiter
prime	ministerpräsident
shuttle	shuttle
regarding	bezüglich
resource	ressource
smoking	rauchen
artist	künstler
leather	leder
thermal	temperatur
morning	vormittag
miles	meilen
liable	haftet
where	wo
worrying	besorgnis
vision	vision
bulgaria	bulgarien
excursions	ausflüge
ignored	ignoriert
declared	erklärten
crossborder	grenzüberschreitenden
concert	konzert
imposing	auferlegt
signs	anzeichen
ends	endet
seat	sitz
relative	relativ
elected	gewählte
namely	nämlich
actively	aktiv
college	college
parking	parkplätze
calendar	kalender
sport	sport
europeans	europäern
harmonised	harmonisieren
fails	versäumt
voluntary	freiwillige
camping	camping
tackling	bewältigung
federal	federal
subsequent	nachfolgenden
review	überprüfung
opening	eröffnung
sites	sites
label	label
weapons	waffen
enough	genug
bureau	präsidium
environmentally	umweltfreundliche
between	zwischen
it	it
import	importieren
justified	gerechtfertigt
reading	lesung
across	quer
affordable	preis-leistungs-verhältnis
notice	ankündigung
infrastructure	infrastruktur
jobs	arbeitsplätze
august	august
corresponding	entsprechenden
legitimacy	legitimität
screen	bildschirm
26	26
uptodate	aktuellen
concentrate	konzentrieren
awards	awards
implemented	implementiert
article	artikels
cities	städte
come	come
undermine	untergraben
concentrated	konzentriert
guitar	songs
dates	termine
installation	installation
missions	einsätze
libya	libyen
implementing	implementierung
residence	residence
safeguard	schutzmaßnahmen
according	zufolge
contract	vertrages
enabling	versetzen
tour	tour
item	nächster
spare	freizeit
railway	eisenbahn
expression	meinungsäußerung
comes	stammt
nearby	gelegenen
duty	pflicht
among	anderem
afterwards	anschließend
cancer	krebs
150	150
effective	effektive
mandate	mandat
por	por
period	periode
insist	bestehen
auditors	rechnungshofs
60	60
twin	twin
strengthening	stärkung
65	65
learning	erlernen
losses	verluste
cancel	stornierung
moreover	überdies
writing	schriftlich
eads	eads
boat	boot
login	anmelden
considering	bedenkt
sensible	vernünftige
combines	kombiniert
cycling	fahrrad
grand	grand
capable	fähig
west	westens
classic	classic
informed	informiert
airlines	airlines
mark	mark
tropical	tropischen
workshop	workshop
red	rot
combined	kombiniert
peaceful	friedliche
linguistic	sprachen
borders	außengrenzen
hardly	kaum
500	500
followup	come
wonderful	wunderbare
direction	richtung
citizenship	unionsbürgerschaft
shopping	einkaufsmöglichkeiten
reaction	reaktion
blame	schuld
offered	angebotenen
formed	gebildet
block	block
reaching	erreichung
observers	beobachter
photos	fotos
observe	beobachten
wake	zuge
minister	ministerin
declaration	erklärung
careful	sorgfältige
spirit	geiste
those	diejenigen
pilot	piloten
case	fall
specialised	spezialisierte
myself	selber
casa	casa
limits	grenzwerte
developing	entwicklungsländern
amend	ändern
mount	monte
cash	liquidität
profiles	profile
cast	geworfen
diverse	vielfältig
ongoing	laufende
policies	politiken
many	viele
cancelled	stornierungen
exist	existieren
shops	geschäften
converted	umgewandelt
region	region
ein	here
aluminium	aluminium
bathrooms	bäder
orientation	orientierung
conferences	konferenzen
then	schaffen,/i
determination	entschlossenheit
soil	böden
engaged	engagiert
coffee	kaffee
deficits	defizite
middle	nahen
default	standardmäßig
pressing	drücken
minds	köpfe
property	eigentum
technology	technologie
everyday	alltag
worry	sorge
tourist	touristische
different	unterschiedliche
develop	entwickeln
author	autor
artists	künstlern
pay	bezahlen
granted	gewährt
s	s
same	gleichen
surveillance	überwachung
gentlemen	herren
html	html
speech	redebeitrag
arguments	argumente
regime	regime
bring	herbeizuführen
events	ereignisse
meaningfully	schlusselwort
status	status
finish	beenden
centuries	jahrhunderte
knowhow	know-how
assist	behilflich
driver	treiber
drives	treibt
producers	erzeuger
persons	personen
newspaper	zeitung
fruit	obst
driven	getrieben
delicate	sensible
changing	ändert
totally	völlig
tradition	tradition
renewable	erneuerbare
costa	costa
modes	verkehrsmittel
largely	weitgehend
charges	gebühren
no	nein
constitutional	konstitutionelle
roughly	grob
severe	schweren
costs	kostet
solve	lösen
relief	erleichterung
components	komponenten
trains	züge
coordinate	koordinieren
model	modells
grounds	messegelände
dimension	dimension
researchers	forscher
charged	zahlt
gdp	bip
summer	sommer
outdoor	außenpool
pakistan	pakistan
being	wesen
money	geldes
guided	führungen
sights	sehenswürdigkeiten
rest	rest
ngos	nro
foot	fuße
violent	gewalt
showed	zeigten
aspect	aspekt
touch	touch
polish	polnische
speed	speed
underline	unterstreichen
weekly	wöchentlich
announcement	ankündigung
renewed	erneuert
budgetary	haushaltsbehörde
euros	euros
thinking	denken
rental	autovermietung
seems	scheint
except	ausnahme
improvement	verbesserung
blog	blog
instrument	instrument
lets	lässt
orchestra	orchester
4	4
overview	überblick
constant	ständige
republic	republik
extensive	umfangreichen
bread	brot
kingdom	königreich
drink	getränk
aspects	aspekte
around	herum
spectacular	spektakuläre
easily	leicht
read	gelesen
papers	zeitungen
dark	dunklen
inflation	inflation
traffic	verkehrs
listening	zuhören
world	welt
accepted	akzeptiert
disappointed	enttäuscht
furniture	möbel
meaning	sinn
satisfaction	zufriedenheit
achieve	erreichung
photographs	fotografien
suppliers	lieferanten
japan	japan
maintained	aufrechterhalten
serves	dient
server	server
facing	konfrontiert
chamber	plenarsaal
audience	publikum
grants	gewährt
t	t
always	stets
resolved	gelöst
output	ausgabe
tower	turm
revision	revision
reduced	reduziert
fulfil	erfüllen
twelve	zwölf
satisfactory	zufriedenstellend
apartments	apartments
madrid	madrid
lebanon	libanon
competition	wettbewerbs
supplementary	zusätzlichen
calculated	berechnet
resorts	ortschaften
specified	angegebene
images	images
diving	tauchen
treatments	behandlungen
bigger	größer
competences	zuständigkeiten
provided	vorausgesetzt
dimensions	dimensionen
windows	windows
confirm	bestätigen
sudan	sudan
tube	u-bahn
recorded	verzeichnet
stops	stationen
conservative	konservativen
deserve	verdienen
zimbabwe	simbabwe
critical	kritische
exit	ausfahrt
deficit	defizit
provides	liefert
provider	provider
happened	geschah
moderate	mittlerer
decent	angemessenen
refer	beziehe
measuring	messung
turkey	türkei
football	fußball
assembly	versammlung
scientific	wissenschaftliche
business	business
seconds	sekunden
sixth	sechsten
equivalent	entspricht
each	jedes
communicate	kommunizieren
unusual	ungewöhnlich
notably	namentlich
broken	unterteilt
meets	erfüllt
leadership	führung
alps	alpen
references	referenzen
authorisation	genehmigung
thailand	thailand
refers	verweist
guides	führer
throw	werfen
beaches	strände
manufacturer	hersteller
comparison	vergleich
stone	stein
ok	ok
stations	stationen
of	mangelnden
industry	industrie
violence	gewalt
discussed	besprochen
develops	entwickelt
side	side
practical	praktische
convenient	bequeme
acp	akp-staaten
stand	stehe
act	act
mixed	gemischten
mean	bedeuten
os	os
or	oder
road	straßenverkehr
ladies	damen
effectively	effektiv
burning	brennen
inclusion	eingliederung
communication	mitteilung
image	image
vacation	urlaub
authorities	behörden
secure	sichere
rising	steigende
lively	lebendigen
determine	bestimmen
parties	parteien
operator	betreiber
adobe	adobe
lastly	schließlich
nowadays	heutzutage
your	deine
intervention	intervention
pharmaceutical	arzneimittel
log	anmelden
prepare	vorzubereiten
area	euroraum
removing	beseitigung
strictly	strikt
there	gibt
racism	rassismus
sides	seiten
strict	strikte
low	niedrige
lot	lot
labelling	etikettierung
cultures	kulturen
decisive	entscheidenden
valley	tal
materials	materialien
intends	beabsichtigt
gain	erlangen
shower	dusche
complete	komplettes
regard	betrachte
tailored	zugeschnitten
amongst	anderem
sophisticated	anspruchsvolle
e	e
technologies	technologies
promote	fördern
with	mit
featuring	szenen
buying	kauf
longer	länger
shortterm	kurzfristige
hire	mieten
october	oktober
applying	anzuwenden
romantic	romantische
embedded	eingebettet
salzburg	salzburg
objective	objektiven
vice	president
adequate	angemessene
local	lokaler
emissions	emissionen
reflection	überlegung
politically	politisch
agree	einverstanden
regimes	regimes
strongly	nachdrücklich
wants	wünscht
vehicles	fahrzeugen
ad	ad
ag	ag
cinema	kino
taste	geschmack
certain	bestimmte
describe	beschreiben
am	bin
sales	umsatz
deep	tiefen
general	allgemeinem
alarm	erinnerung
britain	großbritanniens
reliability	zuverlässigkeit
governed	regiert
file	datei
cathedral	kathedrale
politics	politik
moves	bewegt
kinds	arten
film	film
fill	füllen
cohesion	zusammenhalts
amendments	änderungsanträge
consensus	konsens
ideally	ideal
credibility	glaubwürdigkeit
drivers	treiber
storage	lagerung
2000	2000
vocational	berufliche
insurance	versicherung
rubber	hinten
field	feld
neighbouring	benachbarten
5	5
lifestyle	lebensweise
you	du
thousand	tausend
2007	2007
poor	armen
suites	suites
briefly	kurz
championship	course
games	games
congress	kongress
separate	separaten
students	studenten
translated	übersetzt
symbol	symbol
contextually	kontextuell
m	m²
includes	einschließt
hardware	hardware
important	wichtig
peak	höhepunkt
suited	geeignet
realised	realisiert
tackle	anzugehen
decorated	geschmackvoll
stocks	bestände
unless	sofern
pool	pool
legal	legale
fiscal	steuerlichen
booked	gebucht
remote	entfernten
bilateral	bilateralen
calls	ruft
wife	frau
controlled	gesteuert
invest	investieren
wifi	wifi
contemporary	zeitgenössische
controller	controller
barcelona	barcelona
directors	vorstand
dramatic	dramatischen
u	u
restored	wiederhergestellt
configure	konfigurieren
god	gott
directory	verzeichnis
resolution	entschließung
original	ursprünglichen
external	externen
represent	repräsentieren
all	sämtlichen
surrounded	umgeben
consider	überlegen
chinese	chinesen
aids	aids
caused	verursachte
lack	mangelnden
concern	besorgnis
none	keines
month	monat
founded	gegründet
della	della
tours	touren
mp3	mp3
welfare	tierschutz
talks	gespräche
follow	befolgen
disk	festplatte
decisions	beschlüsse
children	kindern
causes	ursachen
equipment	ausrüstung
apartment	apartment
number	zahl
remarkable	bemerkenswerte
tv	tv
laid	festgelegten
opportunities	chancen
former	ehemaligen
to	um
program	program
highquality	hochwertiger
preserved	bewahrt
14	14
safety	lebensmittelsicherheit
enjoying	erfreuen
presentation	präsentation
barroso	barroso
activities	aktivitäten
belonging	zugehörigkeit
woman	weibliche
premium	premium
worse	schlimmer
returning	rückkehr
infringement	verstoß
checkin	it's
translations	übersetzungen
saved	gerettet
resistance	widerstand
me	mir
fan	fan
difficult	schwierige
decide	entscheiden
got	bekam
sony	sony
ticket	ticket
difference	differenz
condition	bedingung
madam	präsidentin
leads	führt
parliaments	parlamenten
cable	kabel
ageing	älter
arts	arts
list	liste
joined	beigetreten
large	großunternehmen
these	diesen
sand	sand
adjust	anpassen
plain	schlicht
small	klein-
biological	biologische
economically	wirtschaftlich
20th	20.
programme	programms
hoped	hofft
cookies	cookies
ten	zehn
exposed	ausgesetzt
tea	tee
penalties	strafen
streets	straßen
past	vergangenheit
zero	null
design	design
displays	zeigt
publicly	öffentlich
pass	pass
coverage	berichterstattung
further	weitere
functioning	funktionierenden
investment	investment
returned	zurückgegeben
toilet	toilette
will	wille
what	worum
defence	verteidigung
imported	importiert
consumers	verbrauchern
clock	uhr
investing	investieren
sun	sun
section	sektion
brief	kurze
version	version
sur	sur
scientists	wissenschaftlern
tribute	würdigen
racing	rennen
public	öffentliche
contrast	kontrast
movement	freizügigkeit
edited	zuletzt
full	volle
iran	iran
installations	installationen
modify	verändern
certainly	gewiss
answers	antworten
hours	stunden
combating	bekämpfung
tracks	spuren
operating	betriebssystem
relaxation	entspannung
directions	richtungen
method	methode
strong	starkes
respect	respektieren
tragedy	tragödie
arena	arena
speeches	reden
ahead	voraus
houses	häuser
inspired	inspiriert
compliance	einhaltung
allows	erlaubt
experience	erfahrung
optimal	optimale
prior	vorherige
amount	betrag
thursday	donnerstag
advertising	werbung
pick	aufgreifen
action	action
narrow	engen
options	optionen
struggle	kampfes
technique	technik
followed	gefolgt
family	familie
suddenly	plötzlich
requiring	erfordern
transit	verkehrsmitteln
imagine	vorstellen
africa	afrika
capital	kapital
texts	texten
aimed	abzielen
trained	ausgebildet
florence	florenz
select	auszuwählen
languages	sprachen
shareholders	aktionäre
eye	auge
proceed	fortfahren
answered	beantwortet
intense	intensiven
objectives	zielsetzungen
destination	ziel
single	single
two	zwei
governance	governance
damaged	beschädigt
captain	captain
almost	beinahe
amenities	annehmlichkeiten
6	6
taken	ergriffen
promoting	förderung
markets	märkte
achieving	erreichung
minor	kleinere
more	mehr
flat	wohnung
israel	israel
door	tür
knows	kennt
initiated	eingeleitet
definition	definition
canon	canon
regrettable	bedauerlich
emission	emissionen
putin	putin
telephone	telefon
tested	getestet
flag	flagge
controlling	kontrollieren
stick	festhalten
particular	besonderem
known	bekannt
foundations	grundlagen
fate	schicksal
producing	produzieren
sovereignty	souveränität
glad	froh
hostelsclub	hostelsclub
town	town
helped	geholfen
keeping	beibehaltung
debates	aussprachen
hour	stunde
recall	erinnere
der	kulturen
des	palais
installing	installation
debated	erörtert
paragraph	ziffer
del	del
dem	met
den	van
learn	lernen
strategies	strategien
male	male
broad	breiten
history	geschichte
beautiful	wunderschönen
compare	vergleichen
finland	finnland
stood	standen
challenging	anspruchsvollen
division	division
lives	menschenleben
longterm	langfristige
functions	funktionen
share	teilen
accept	akzeptieren
terrible	schreckliche
autumn	herbst
prodi	prodi
minimum	minimum
numbers	zahlen
purchased	gekauft
arise	auftauchen
phrase	schlusselphrase
species	arten
federation	föderation
concept	konzept
huge	riesigen
respective	jeweiligen
answer	beantworten
court	gerichtshofs
goal	ziels
rather	eher
plans	pläne
acts	rechtsakte
conducted	durchgeführte
ratified	ratifiziert
maps	karten
transfers	transfer
option	option
reject	ablehnen
iso	iso
movements	bewegungen
explains	erläutert
creature	kreatur
recording	erfassung
fr	fr
mysql	mysql
tried	versuchten
countryside	landschaft
advice	ratschläge
high	hohes
derived	leitet
internet	internets
reflect	widerspiegeln
panoramic	panoramablick
director	direktor
blood	blut
coming	kommenden
horizontal	liegende
authentic	echt
response	reaktion
fascinating	faszinierende
tourists	touristen
a	ein
refuse	verweigern
short	kurzen
documentation	dokumentation
departure	abreise
supervision	aufsicht
coal	kohle
wishes	wünscht
responsibility	verantwortung
fundamental	grundlegendes
media	medien
banks	banken
pleasure	vergnügen
incentive	anreiz
officials	beamten
dream	traum
playing	abspielen
help	helfen
september	september
essence	wesen
flowers	blumen
entries	einträge
soon	bald
für	hochschule
installed	installiert
disabled	behinderten
held	abgehalten
attitude	haltung
paper	papier
through	durchlaufen
committee	ausschuss
committed	begangen
existence	existenz
suffer	erleiden
its	seine
roots	wurzeln
islam	islam
24	24
25	25
style	stil
27	27
rapidly	rasch
21	21
22	22
23	23
c	c
sale	verkauf
28	28
29	29
actually	eigentlich
late	spät
resort	resort
absence	abwesenheit
parts	teile
systems	systeme
relate	entdeckst
cross	kreuz
argentina	argentinien
cool	frische
might	könnte
colleague	kollegin
whereby	wonach
good	guter
return	rückkehr
calm	beruhigen
than	anstatt
seeking	strebt
food	nahrungsmitteln
propose	vorzuschlagen
ye	werdet
primary	vorrangige
framework	rahmens
walls	mauern
communities	gemeinschaften
separately	separat
terrorism	terrorismus
association	association
instructions	anweisungen
restrict	einschränken
document	dokument
holiday	holiday
occasions	gelegenheiten
intervene	eingreifen
normally	normalerweise
capability	fähigkeit
courses	kurse
someone	jemanden
stopped	einhalt
experiencing	erleben
found	gefunden
front	front
ports	häfen
education	bildung
referred	verwiesen
heavy	schwere
week	woche
harm	schaden
everyone	jedermann
england	england
mental	geistige
weight	gewicht
generation	generation
posts	posten
fish	fisch
hard	harte
reduce	reduzieren
idea	idee
extended	ausgedehnt
expect	erwarte
undertake	verpflichten
measurement	messung
organised	organisierte
operation	operation
beyond	hinausgeht
event	ereignis
really	wirklich
stands	steht
initiatives	initiativen
lovers	liebhaber
funding	finanzierung
alcohol	alkohol
p	p.
robert	robert
since	seitdem
unknown	unbekannten
publish	veröffentlichen
research	forschung
participants	teilnehmern
conclusions	schlussfolgerungen
health	gesundheit
hill	hill
7	7
paradise	paradies
print	drucken
grew	wuchs
issue	themas
occurs	auftritt
highway	autobahn
regards	anbelangt
reporting	berichterstattung
belief	überzeugung
friday	freitag
horse	pferd
pleasant	angenehmen
extraordinary	außerordentlichen
reason	grund
base	rechtsgrundlage
styles	stil
conditioning	klimaanlage
members	mitgliedern
organising	organisieren
put	bringe
approach	ansatzes
sauna	sauna
beginning	anfang
generate	generieren
temperature	temperatur
allocation	vergabe
owners	eigentümer
benefits	vorteilen
service	dienstes
launch	start
computers	computern
published	veröffentlichten
running	laufen
american	american
w	w
leading	führende
consequence	konsequenz
syria	syrien
castle	burg
fallen	gesunken
partnerships	partnerschaften
feed	ernährung
logistics	logistik
major	major
simply	schlicht
prevent	verhindern
feel	fühle
radical	radikale
reflected	widerspiegeln
welcome	begrüße
feet	füßen
enlarged	erweiterten
revolution	revolution
done	getan
approximately	ungefähr
fees	gebühren
wages	löhne
miss	verpassen
causing	verursachen
stage	etappe
regret	bedauere
passes	fließt
story	geschichte
php	php
heads	staats-
guest	guest
guaranteeing	gewährleistung
script	skript
introduction	einführung
together	gemeinsam
financed	finanziert
least	wenigsten
belongs	angehört
regulation	verordnung
station	bahnhof
expand	erweitern
saint	saint
trails	wanderwege
rates	laterooms.
scheme	regelung
finances	finanzen
store	store
too	allzu
selling	verkauf
warmly	herzlich
passed	vergangen
relationship	beziehung
plaza	plaza
teacher	lehrer
hotel	hotel
park	park
immediate	sofortige
optical	optischen
modernisation	modernisierung
doctors	ärzte
focusing	konzentriert
translation	übersetzung
believe	glaube
convinced	überzeugt
obama	obama
king	könig
financing	finanzierung
hundred	hundert
iranian	iranischen
double	double
incorporate	integrieren
aims	zielt
ranging	angefangen
youth	jugend
i	ich
determined	entschlossen
2020	2020
supposed	angeblich
sole	ermessen
fishermen	fischer
toward	richtung
treated	behandelt
declare	erkläre
interactive	interaktiven
indonesia	indonesien
basically	grunde
outstanding	herausragenden
strengthen	stärken
imports	einfuhren
urgently	dringend
alongside	neben
organisations	organisationen
initially	anfangs
substantial	beträchtliche
contest	wettbewerbs
ambitious	ehrgeizig
my	meinem
concentration	konzentration
orders	bestellungen
vulnerable	anfällig
collapse	zusammenbruch
sell	verkaufen
defects	mängel
nights	nächte
para	para
depending	je
check	verfügbarkeit
self	selbst
scotland	schottland
officers	beamten
targets	zielvorgaben
walk	spaziergang
majority	mehrheit
articles	artikeln
without	ohne
directives	richtlinien
build	bauen
finding	feststellung
contractual	vertragspartner
gym	fitnessraum
province	provinz
play	spielen
added	hinzugefügt
electric	elektrischen
knowing	wusste
afghanistan	afghanistan
quote	zitiere
victim	opfer
sets	festlegt
reach	reach
quota	quoten
react	reagieren
anniversary	jahrestag
75	75
charm	charme
negotiating	verhandeln
significant	bedeutende
70	70
services	dienstleistungen
accepting	akzeptieren
measured	gemessen
approved	genehmigt
achievement	erreichung
appear	erscheinen
constructed	gebaut
directive	richtlinie
bug	fehler
mobile	mobile
performances	leistungen
clear	klare
sometimes	manchmal
doubts	zweifel
km	km
traditional	traditionellen
part	teil
organise	organisieren
bodies	gremien
clean	sauberen
justify	rechtfertigen
microsoft	microsoft
joining	beitreten
science	wissenschaft
taxi	taxi
thomas	thomas
particularly	besonders
phenomenon	phänomen
gold	gold
kosovo	kosovo
obligations	pflichten
consult	konsultieren
favour	gunsten
session	sitzungsperiode
relation	verhältnis
freight	güter
multilateral	multilaterale
stores	speichert
fine	feinen
find	finde
occupation	besetzung
impact	auswirkung
access	zugangs
giant	riesige
copyright	copyright
consistently	konsequent
justice	gerechtigkeit
heavily	stark
distributed	verteilt
waiting	wartet
ball	ball
penalty	todesstrafe
failed	gescheitert
flights	flüge
pretty	hübschen
factor	faktor
8	8
circle	kreis
proximity	nähe
tyrol	südtirol
his	seinem
hit	getroffen
rose	rose
permission	erlaubnis
dependent	abhängig
connections	verbindungen
express	express
sunny	sonnigen
kind	art
trees	bäume
cheaper	billiger
famous	berühmten
feels	fühlt
courage	mut
valuable	wertvolle
closely	eng
shared	geteilt
during	während
him	ihm
contextual	kontextuellen
pdf	pdf
enemy	feind
budapest	budapest
resolve	lösen
keyword	schlusselwortern
transitional	vorübergehend
sources	quellen
medicines	arzneimitteln
generally	generell
remove	entfernen
banking	banken
investigate	untersuchen
interim	zwischenzeit
croatia	kroatien
common	gemeinsamen
withdrawal	rückzug
switzerland	schweiz
x	x
river	flusses
wrote	schrieb
restaurants	restaurants
characteristics	merkmale
scenery	landschaft
bars	bars
set	set
art	kunst
opposed	lehnen
supporting	unterstützen
principal	hauptziel
intelligence	intelligenz
prague	prag
enjoyed	genossen
sex	sex
culture	kultur
see	größeres
individual	individueller
migration	migration
sea	meeres
lisbon	lissabonner
close	enge
forthcoming	bevorstehenden
labour	arbeitsmarktes
pacific	ozean
project	projekts
evaluation	evaluierung
learnt	gelernt
stance	haltung
expert	experten
visiting	besuch
movie	film
currently	zurzeit
electoral	wahlkampf
heading	rubrik
unions	gewerkschaften
won	gewann
various	verschiedenen
affairs	angelegenheiten
contrary	gegenteil
moving	bewegt
firmly	festen
numerous	zahlreichen
corruption	korruption
wide	breites
europe	europa
latin	lateinamerika
recently	kürzlich
historical	historische
missing	fehlenden
targeted	gezielte
sold	verkauft
attention	aufmerksamkeit
aircraft	flugzeugen
death	tod
accessible	zugänglich
opposition	opposition
competent	kompetenten
electrical	elektrische
remaining	verbleibenden
both	beide
prospects	aussichten
enables	immo
last	last
reverse	rückgängig
license	lizenz
appropriations	haushaltsmittel
solely	ausschließlich
annual	jährlichen
foreign	außen-
sensitive	sensiblen
connection	internetanschluss
became	geworden
n	n
forgotten	vergessen
let	lasst
approve	billigen
finds	findet
millions	millionen
liked	gewünscht
licence	lizenz
luxurious	luxuriösen
mini	mini
reasons	gründe
sweet	feine
das	much
recycling	verwertung
harbour	harbour
regulated	geregelt
adaptation	anpassung
linux	linux
openness	offenheit
desktop	desktop
mission	mission
expensive	teurer
decline	niedergang
ensures	sichert
java	java
publishing	verlag
pt	pt
arrest	haftbefehl
monthly	monat
create	schaffen
acceptance	akzeptanz
creativity	kreativität
due	ratschlag
strategy	strategie
pc	pc
secret	geheimen
describes	beschreibt
complicated	kompliziert
ensured	sichergestellt
ireland	irland
collected	gesammelt
adoption	verabschiedung
territory	hoheitsgebiet
meeting	konferenz-
pl	pl
treatment	behandlung
firm	feste
dialogue	dialogs
lived	gelebt
flight	flug
gay	gay
passengers	fluggäste
fire	feuer
ages	mittelalter
gas	gas
precision	präzision
new	neuen
mine	freundin
fund	fonds
whatever	egal
engage	engagieren
understand	verstehe
representative	vertreterin
systematic	systematische
demand	nachfrage
receive	empfangen
towns	städten
presented	vorgestellt
developments	entwicklungen
plants	pflanzen
georgia	georgien
utmost	größter
look	look
talking	reden
solid	soliden
judicial	gerichtsverfahren
reliable	zuverlässige
expanded	erweitert
elections	wahlen
healthy	gesunde
while	weile
replaced	ersetzt
smart	smart
formats	formate
fun	spaß
fleet	flotte
di	di
guide	guide
engineers	ingenieure
scheduled	geplant
larger	größeres
portugal	portugal
voters	wähler
backing	unterstützung
wherever	wohin
von	johann
binding	verbindliche
rio	rio
itself	selbst
skype	skype
ready	bereit
limit	begrenzen
leaving	verlässt
examine	untersuchen
gone	gegangen
cuisine	cuisine
italy	italien
earn	verdienen
grant	gewähren
characterised	gekennzeichnet
belong	angehören
textile	textilien
rules	regeln
delicious	köstliche
complaints	beschwerden
virtually	praktisch
widely	verbreiteten
peoples	völkern
9	9
products	erzeugnissen
advise	raten
composition	zusammensetzung
danish	dänische
higher	höheren
development	entwicklung
used	verwendet
temporary	vorübergehend
paths	wanderwege
keys	tasten
comprehensive	umfassendes
gallery	gallery
negotiate	verhandeln
flows	fließt
holidays	ferien
moment	moment
levels	ebenen
arrived	angekommen
purpose	zweck
necessity	notwendigkeit
robust	soliden
brussels	brüssel
residents	bewohner
recent	jüngsten
early	frühen
lower	niedrigere
task	aufgabe
bonds	anleihen
database	datenbank
navigation	navigation
poland	polen
spent	ausgegeben
county	kreis
obviously	offensichtlich
sports	sportarten
person	person
edge	rande
machinery	maschinen
withdraw	zurückzuziehen
consistency	kohärenz
swiss	swiss
organization	welthandelsorganisation
meanwhile	zwischenzeit
spend	ausgeben
prevention	prävention
things	dinge
responsible	verantwortungsvolle
slowly	langsam
desk	schreibtisch
networks	netzwerke
competitive	wettbewerbsfähig
isolated	isoliert
risks	risiken
press	presse
shape	gestalt
oral	mündliche
questions	anfragen
unesco	unesco
useful	nützliche
alternative	alternative
northern	nördlichen
continent	kontinent
unto	sprach
addresses	adressen
wage	löhne
tables	tabellen
emerging	schwellenländer
cut	kürzen
helping	helfen
waste	abfällen
cup	cup
informal	informellen
workers	arbeitnehmern
guaranteed	garantiert
international	internationalen
exclusively	exklusiv
innovations	innovationen
source	source
internal	internen
parents	eltern
exhibition	ausstellung
tabled	eingereicht
presidents	präsidenten
input	eingabe
violations	verletzungen
guarantees	garantien
administrative	administrativen
transformation	umwandlung
surprised	überrascht
chairman	vorsitzenden
associations	verbände
customers	kunden
australia	australien
victims	opfern
amended	geänderten
lacking	mangelt
format	format
evaluate	bewerten
couple	paar
unlimited	uneingeschränkte
judgement	urteil
matters	angelegenheiten
game	spiels
marked	markiert
bit	bisschen
sustainable	nachhaltigen
projects	projekte
formal	offizielle
summit	gipfels
websites	websites
imposed	verhängt
d	d
follows	folgt
pillar	säule
decisionmaking	entscheidungsfindung
austria	österreich
ignore	ignorieren
collect	sammeln
individuals	einzelpersonen
unstable	instabilität
popular	beliebte
stylish	stilvolle
collective	kollektiven
google	google
methods	methoden
course	kurs
absolutely	absolut
obliged	verpflichtet
creation	schaffung
magnificent	großartigen
back	rückseite
metres	metern
delegation	delegation
urgent	dringende
countless	unzähligen
towards	richtung
examples	beispiele
sight	augen
mirror	spiegel
cd	cd
editing	bearbeitung
civilisation	zivilisation
ourselves	selber
delivered	gelieferten
gradually	allmählich
scale	maßstab
contacts	kontakten
affects	auswirkt
decision	beschlusses
transactions	transaktionen
integration	integration
notification	meldung
religion	religion
connecting	verbinden
eliminate	beseitigen
innovation	innovation
dating	stammt
pools	schwimmbad
temple	tempel
minimal	minimum
either	entweder
investigations	ermittlungen
object	objekt
patient	patienten
™	®
300	300
unlikely	unwahrscheinlich
processing	verarbeitung
continuing	anhaltende
agreement	abkommens
refused	verweigert
step	schritt
fee	gebühr
twenty	zwanzig
served	diente
relating	betreffend
by	by
neighbourhood	nachbarschaftspolitik
handled	bearbeitet
faith	glauben
substances	substanzen
goods	gütern
certificate	zertifikat
anything	irgend
most	meisten
refugees	flüchtlinge
lord	euer
prove	beweisen
virus	virus
page	site
deserves	verdient
range	palette
regular	regelmäßige
dialog	dialog
germany	deutschland
italian	italienische
consequently	folglich
farmers	landwirten
silence	stille
pollution	verschmutzung
credible	glaubwürdig
repair	reparatur
real	realer
letter	brief
terrorists	terroristen
favourable	günstigen
within	innerhalb
integral	fester
servers	servern
currency	währung
nothing	nichts
appropriate	geeignete
because	weil
master	master
primarily	primär
lesson	lektion
france	frankreich
munich	münchen
sightseeing	besichtigung
realisation	realisierung
statistics	statistiken
computer	computer
96	96
spending	ausgaben
extremely	extrem
apparently	anscheinend
placing	platzieren
question	anfrage
fast	schnellen
custom	maßgeschneiderte
indoor	innen
thirdly	drittens
consultation	konsultation
confirmation	bestätigung
suit	passen
certification	zertifizierung
uss	uss
translate	übersetzen
sections	abschnitte
opens	öffnet
etc	etc
files	dateien
considerably	beträchtlich
himself	selbst
fax	fax
elsewhere	anderswo
jewish	jüdische
cologne	köln
criteria	kriterien
immigration	einwanderung
applicable	anwendbar
fisheries	fischereipolitik
properly	ordnungsgemäß
link	link
library	bibliothek
russian	russischen
subsidiary	niederlassung
line	zeile
considerable	beträchtliche
raising	anhebung
posted	eintrag
info	info
hair	haare
boards	aufsichtsrat
travelling	reisen
rejection	ablehnung
welcoming	gemütliches
characteristic	charakteristischen
sounds	sounds
declarations	erklärungen
up	up
us	us-regierung
par	par
planet	planet
greatly	erheblich
un	uno
uk	uk
sum	summe
continuously	kontinuierlich
highlight	highlight
autonomous	autonomen
landscapes	landschaften
called	aufgerufen
recognition	anerkennung
camp	camp
ordered	bestellt
adults	erwachsene
spiritual	geistige
defined	definierten
metal	metall
influence	einfluss
entrance	eingang
doesn	egal
dog	hund
duration	dauer
engineering	engineering
warning	warnung
evening	abend
ingredients	zutaten
chat	chat
usd	usd
whom	wem
codes	codes
amounts	beträge
peace	frieden
fears	ängste
teams	teams
preventing	verhinderung
club	club
politicians	politikern
definitely	definitiv
functionality	funktionalität
transport	verkehr
income	einkommen
department	abteilung
bush	bush
nice	nizza
draw	lenken
elements	elemente
users	benutzern
gross	grob
favourite	bevorzugten
mediumsized	mittlere
problems	probleme
visits	besuche
prepared	vorbereitet
regulations	verordnungen
generated	generiert
territorial	territorialen
allowing	zuzulassen
armed	bewaffneten
personalised	persönlicher
reservation	reservierung
song	lied
charming	charmante
meals	mahlzeiten
structure	struktur
ago	jahren
independently	selbständig
land	flächen
implies	einschließt
overlooking	blick
practically	praktisch
dvd	dvd
cooking	kochen
required	geforderten
wellbeing	wohlbefinden
departments	abteilungen
institutions	institutionen
2002	2002
2003	2003
depth	tiefe
2001	2001
2006	2006
presenting	vorlegt
2004	2004
2005	2005
far	weitem
fresh	frischen
2008	2008
2009	2009
requires	erfordert
having	nachdem
once	einst
sector	sektor
lithuania	litauen
code	kodex
partial	teilweise
advisory	gutachten
delivery	lieferung
issued	ausgestellt
results	ergebnisse
existing	bestehender
maastricht	maastricht
luxembourg	luxemburg
broader	breiter
go	go
golf	golf
adjustment	anpassung
contributions	beiträge
issues	themen
seemed	schien
compact	kompakte
turkish	türkische
disposal	entsorgung
concerned	besorgt
young	junge
send	senden
appointed	ernannt
intensive	intensive
culinary	kulinarische
helps	hilft
excluded	ausgeschlossen
stable	stabilen
ambience	ambiente
breach	verstoß
organisational	sicherheitsmaßnahmen
include	umfassen
friendly	freundlichen
resources	ressourcen
labels	etikettierung
agents	vermittler
garden	garden
torture	folter
outside	außerhalb
automotive	automobilindustrie
continues	fort
conditions	bedingungen
wave	welle
indication	angabe
migrants	migranten
putting	stecken
partsession	plenarsitzung
coalition	koalition
telling	erzählen
specific	spezifischen
drinking	trinkwasser
continued	fortgesetzt
categories	kategorien
arrange	vereinbaren
timely	rechtzeitig
entire	gesamte
magic	magic
transmission	übermittlung
positions	positionen
notes	zimmerbeschreibung
sanctions	sanktionen
michael	michael
fewer	weniger
deals	fügt
threat	bedrohung
race	rasse
min	min
dealt	behandelt
businesses	betriebe
inspection	prüfung
noted	festgestellt
concluded	abgeschlossen
smaller	kleineren
wording	wortlaut
mediterranean	mittelmeerraum
modified	modified
carefully	sorgfältig
bedrooms	schlafzimmern
video	video
earth	earth
download	herunterzuladen
zu	every
copenhagen	kopenhagener
click	klicken
universities	universitäten
districts	viertel
developed	entwickelten
power	power
paintings	gemälde
giving	einzuräumen
saw	sahen
multimedia	abspielen
expressed	geäußerten
practices	praktiken
cell	zellen
paying	bezahlen
19th	19.
indian	indischen
playa	playa
kyoto	kyoto
firms	firmen
exercise	übung
3d	3d
body	körpers
completion	vollendung
focuses	konzentriert
delighted	erfreut
chose	entschied
degree	grad
exchange	exchange
respectively	beziehungsweise
commercial	kommerzielle
jointly	gemeinsam
highly	höchst
believed	glaubt
explore	erforschen
objects	objekte
poverty	armut
euro	euroraum
others	andere
consideration	überlegung
fifteen	fünfzehn
closing	schließung
extreme	extremen
ukraine	ukraine
great	großartige
biodiversity	artenvielfalt
parameters	parameter
metro	metro
technical	technische
32	32
31	31
30	30
37	37
36	36
35	35
34	34
engine	motor
harmonisation	harmonisierung
resulting	resultierenden
california	kalifornien
skin	haut
opinion	stellungnahme
implement	umzusetzen
makes	macht
guidance	anleitung
patents	patente
composed	bestehend
named	benannt
apple	apple
danger	gefahr
egypt	ägypten
win	gewinnen
manage	verwalten
private	privaten
homepage	homepage
addressed	angegangen
subcategories	out
names	namen
motor	motor
apply	anwenden
resolutions	entschließungen
boasts	besticht
standing	ständigen
use	verwenden
exciting	spannende
from	aus
stream	strom
consumption	verbrauch
freedoms	freiheiten
remains	bleibt
illegal	illegale
examined	geprüft
ministers	ministerrat
next	nächstes
few	wenigen
doubt	zweifel
examination	prüfung
vehicle	fahrzeug
timetable	zeitplan
communications	mitteilungen
themselves	selbst
panel	gremium
dreams	träume
start	anfangen
reflects	widerspiegelt
belgian	belgische
sort	art
bureaucracy	bürokratie
parliament	parlament
journalists	journalisten
upcoming	bevorstehende
on	haushaltsausschusses
started	begonnen
tennis	tennis
equity	gerechtigkeit
occurred	aufgetreten
cooperate	kooperieren
meant	bedeutete
trail	spur
carrying	durchführt
transatlantic	transatlantischen
baby	baby
central	mittel-
iii	iii
potential	potenzial
women	frauen
customer	kunde
sample	probe
account	account
vienna	wien
animals	tieren
f	f
this	dieses
plan	plan
ride	fahrt
clients	clients
functional	funktionierende
pour	pour
recession	rezession
anywhere	irgendwo
obvious	offensichtlich
client	client
uses	nutzt
island	insel
meet	erfüllen
compulsory	obligatorischen
institute	instituts
proof	beweis
control	control
beijing	peking
reserved	vorbehalten
links	links
providers	anbietern
process	prozesses
tax	steuer
purposes	zwecke
pieces	stücke
publications	publikationen
professor	professor
application	applikation
something	etwas
sought	gesucht
founding	gründung
standard	standard
voice	stimme
gains	gewinne
hesitate	zögern
educational	erziehung
united	vereinigten
varied	vielfältig
democracy	demokratie
sit	sitzen
protect	schützen
holds	hält
differences	differenzen
arrangement	anordnung
regions	regionen
located	located
bmw	bmw
winners	gewinner
forest	wald
animal	tierschutz
instead	stattdessen
native	muttersprache
establishment	errichtung
banned	verboten
proven	bewährten
airline	fluggesellschaft
profile	profil
parliamentary	parlamentarische
buildings	gebäuden
blocks	blockiert
y	y
gentoo	gentoo
farm	bauernhof
watch	watch
waters	gewässern
philosophy	philosophie
collection	kollektion
3	3
islamic	islamischen
abuse	missbrauch
leisure	freizeit
records	platten
ethnic	ethnische
monitoring	überwachung
foremost	zuallererst
sie	you
solidarity	solidarität
efficiently	effizient
eight	acht
light	lichte
picturesque	malerische
lines	linien
element	element
emphasise	betonen
chief	chief
spain	spanien
funded	finanziert
allow	zulassen
healthcare	gesundheitsversorgung
subsequently	anschließend
software	software
divided	unterteilt
preparing	vorbereiten
burma	birma
six	sechs
coordinated	koordinierte
producer	produzenten
produces	produziert
institutional	institutionelle
farming	landwirtschaft
manufactured	hergestellten
wedding	hochzeit
reserves	reserven
outlook	outlook
produced	produziert
whilst	während
own	eigenen
including	einschließlich
looks	aussieht
gender	geschlechter
mentioned	erwähnt
agricultural	landwirtschaftliche
earlier	vorhin
perfect	perfekte
lounge	lounge
negotiated	ausgehandelt
le	le
exclusion	ausgrenzung
la	la
chosen	ausgewählt
ll	games
ships	schiffe
responsibilities	verantwortlichkeiten
winning	gewinnen
meantime	zwischenzeit
age	zeitalter
permanent	ständigen
degrees	grad
button	schaltfläche
instruments	instrumenten
covered	abgedeckt
criminal	kriminellen
wellknown	bekannte
2010	2010
2013	2013
2012	2012
puts	legt
designs	designs
€	€
fourth	vierte
material	materiellen
cover	abdecken
emphasised	betonte
mention	erwähnen
cutting	schneiden
hands	händen
trade	handels
transparent	transparenten
presidential	präsidentschaftswahlen
strive	streben
going	werde
february	februar
measures	maßnahmen
airports	flughäfen
urge	eindringlich
profound	tief
edit	bearbeiten
undertaking	zusage
university	universität
covering	abdecken
identified	identifiziert
sufficiently	hinreichend
alike	gleichermaßen
truth	wahrheit
interview	interview
accompanied	begleitet
stock	börse
nationals	angehörige
experienced	erfahrenen
lie	liegen
studios	studios
female	weiblichen
doing	tut
adventure	abenteuer
heated	debatten
serbia	serbien
staying	aufenthalts
related	verwandten
kitchen	küche
society	society
frequency	häufiger
variety	vielzahl
measure	maßnahme
password	passwort
relates	bezieht
80	80
differ	abweichen
agriculture	landwirtschaft
sandy	sandstrand
analysis	analyse
category	kategorie
respects	respektiert
attend	teilzunehmen
kids	kinder
house	house
defend	verteidigen
day	tages
settlement	siedlung
specifications	spezifikationen
socalled	sogenannten
reputation	ruf
electronics	elektronik
cause	ursache
integrated	integrierten
announced	angekündigt
meps	parlamentarier
afford	leisten
requests	anfragen
thanking	danken
liberalisation	liberalisierung
ecb	ezb
wines	weine
southern	südlichen
activity	aktivität
transfer	transfer
clarify	klären
approaches	ansätze
surely	sicherlich
york	york
trends	trends
usual	üblichen
regulatory	rechtsrahmen
defining	festlegung
interaction	interaktion
allies	verbündeten
her	ihrem
g	g
applications	applikationen
route	route
latest	neueste
ask	bitten
membership	mitgliedschaft
keep	behalten
keen	bedacht
length	länge
ratification	ratifizierung
assumed	ausgegangen
hence	folglich
retain	beizubehalten
retail	handels-
facilitate	erleichtern
museum	museum
south	south
finest	schönsten
martin	martin
powerful	mächtige
scene	szene
owned	besitz
strategic	strategische
improving	verbesserung
improvements	verbesserungen
submit	einreichen
proposing	vorschlägt
owner	eigentümer
reached	erzielte
precisely	exakt
quality	qualität
straight	sofort
destinations	zielen
legislative	legislativen
has	hat
management	management
bonus	bonus
publication	publikation
privacy	privatsphäre
festival	festival
data	daten
demonstration	demonstration
achieved	erreicht
traveller	reisenden
system	system
relations	beziehungen
priority	priorität
their	ihre
attack	angriff
santa	santa
palestine	palästina
structural	strukturelle
perfectly	perfekt
final	endgültigen
interests	interessen
enforcement	durchsetzung
stars	sternen
square	square
academy	academy
explanation	erklärung
nobody	niemand
debate	debatte
lists	listen
israeli	israelischen
checking	überprüfung
environmental	umwelt-
chemicals	chemikalien
shall	werde
casino	casino
deeply	zutiefst
july	juli
elite	elite
institution	institution
steel	stahl
loved	angehörigen
colleagues	kollegen
sectors	sektoren
split	split
submitted	nachfolgend
compensation	entschädigung
vat	mehrwertsteuer
reproduction	vervielfältigung
visited	besuchten
providing	bereitstellung
distinguished	unterschieden
bet	wetten
are	sind
counter	widerspricht
false	falschen
delay	verzögerung
partnership	partnerschaft
comfortable	komfortable
discussions	diskussionen
buy	kaufen
defending	verteidigung
have	haben
need	brauchen
sky	himmel
border	grenze
linked	verknüpft
viewed	angesehen
she	arbeitete
est	est
afraid	fürchte
dishes	gerichte
inform	informieren
pursued	verfolgten
agency	agentur
message	botschaft
si	si
parks	parks
emerged	entstanden
instance	instanz
archive	archiv
concerns	bedenken
which	denen
bus	bus
nonsmoking	nichtraucherzimmer
subject	gegenstand
mit	second
villas	villen
worldwide	weltweite
fuels	energieträger
led	führten
agenda	agenda
combat	bekämpfen
centre	zentrums
collaboration	mitarbeit
who	wer
harmful	schädlichen
intentions	absichten
visa	visum
connected	angeschlossen
preparations	vorbereitungen
palace	palace
preliminary	vor-
device	gerät
threats	bedrohungen
future	künftige
segment	segment
payment	zahlung
2011	2011
statute	statut
deny	verweigern
reduces	reduziert
consequences	konsequenzen
wish	wünsche
stronger	stärkeren
disease	krankheit
dollar	dollar
face	gesicht
pipe	illusion
proceedings	gerichtsverfahren
talk	reden
1995	1995
mechanical	mechanische
lakes	seen
built	gebaut
painting	malerei
fact	tatsache
morocco	marokko
impression	eindruck
atmosphere	atmosphäre
selection	auswahl
courts	gerichten
kg	kg
per	pro
violation	verletzung
please	bitte
agreed	vereinbarten
supported	unterstützten
anyway	ohnehin
connect	verbinden
purely	rein
reference	verweis
expressing	auszudrücken
democrats	demokraten
bedroom	schlafzimmer
portfolio	portfolio
fear	furcht
asylum	asyl
eyes	augen
pleased	erfreut
decade	jahrzehnt
staff	personals
partners	partnern
trying	versuchen
based	based
knowledge	kenntnisse
comfort	comfort
winner	gewinner
fans	fans
controls	kontrollen
should	sollten
terminal	terminal
surroundings	umgebung
bases	grundlagen
candidates	kandidaten
fuel	verbrauch
riding	reiten
piano	flügel
b	b
thousands	tausenden
interested	interessierten
hope	hoffe
regularly	regelmäßig
move	bewegen
handle	umzugehen
listened	zugehört
cuba	kuba
convert	umwandlung
photography	fotografie
background	hintergrund
maritime	seeverkehr
unacceptable	inakzeptabel
120	120
joint	gemischten
community	gemeinschaft
fraud	betrügereien
legitimate	legitimen
words	wörter
probably	wahrscheinlich
buyer	käufer
arranged	zusammengestellt
years	jahren
procedures	verfahren
already	bereits
nearly	beinahe
areas	gebiete
quiet	ruhigen
following	folgenden
processes	prozesse
committees	ausschüssen
circulation	umlauf
tobacco	tabak
ended	endete
wellness	wellness
state	staates
taxes	steuern
calling	fordert
influenced	beeinflusst
proved	erwiesen
stuff	slideshows
processed	verarbeitet
gran	gran
contain	enthalten
an	durchschnittlich
fixed	behoben
experiences	erfahrungen
®	®
generations	generationen
terrace	terrasse
strengthened	gestärkt
requirement	anforderung
albania	albanien
exists	existiert
acquired	erworben
smooth	ablauf
frame	rahmens
humans	mensch
we	wir
module	modul
operates	betreibt
edition	edition
reinforce	verstärken
korea	korea
yugoslavia	jugoslawien
employed	beschäftigte
enhanced	verstärkten
austrian	österreichische
atlantic	atlantik
progressive	schrittweise
battery	batterien
situation	situation
closer	engere
error	fehler
wealth	reichtum
reform	reform
pattern	muster
tend	tendenz
premises	räumlichkeiten
written	schriftliche
difficulties	schwierigkeiten
identification	identifizierung
closed	geschlossen
understood	verstanden
progress	fortschritts
neither	weder
email	email
mainly	hauptsächlich
bought	gekauft
industries	industrien
comparable	vergleichbare
javascript	javascript
bound	gebunden
bed	bed
superior	superior
importance	wichtigkeit
deliver	liefern
agencies	agenturen
efficiency	effizienz
job	job
lost	verloren
key	schlüssel
police	polizei
precious	wertvollen
configuration	konfiguration
optional	optional
distribution	distribution
ban	verbot
thank	danken
restrictions	beschränkungen
weeks	wochen
gmbh	gmbh
plugin	plugin
career	karriere
freely	frei
invited	eingeladen
acknowledge	anerkennen
escape	entgehen
equal	chancengleichheit
presentations	präsentationen
trips	ausflüge
fulfilled	erfüllt
assure	versichern
admit	zugeben
succeed	gelingen
figures	figuren
behaviour	verhalten
passing	weitergabe
heart	herz
camera	kamera
journey	reise
otherwise	andernfalls
comment	kommentar
detailed	detaillierten
adjusted	angepasst
relevant	relevanten
co	co.
travellers	reisende
cm	cm
conclude	abschließen
wall	wall
removal	beseitigung
tuesday	dienstag
wonder	wunder
environments	umfeld
vicinity	unmittelbarer
packaging	verpackungen
interface	interface
company	company
carbon	co2-emissionen
table	tabelle
allocated	zugewiesen
600	600
april	april
debt	verschuldung
videos	videos
second	zweite
addition	zusatz
discrimination	diskriminierung
trademark	markenzeichen
copies	kopien
cent	prozent
underlying	zugrunde
genetic	genetisch
willing	willens
condemn	verurteilen
treat	behandeln
gaza	gaza
indicators	indikatoren
proposal	vorschlags
improve	verbessern
suggestions	anregungen
universal	universal
killed	getötet
choose	wählen
faced	konfrontiert
diversity	vielfalt
24hour	boote
league	liga
sweden	schweden
moved	verschoben
sufficient	ausreichende
climate	klima
intelligent	intelligente
al	al
made	made
finished	fertigen
ensuring	sicherstellung
expenditure	ausgaben
hamburg	hamburg
tangible	konkretes
fellow	mitbürger
despite	trotz
present	gegenwart
homes	häuser
novel	roman
laser	optische
abandoned	aufgegeben
unlike	gegensatz
virtual	virtuelle
decades	jahrzehnte
means	bedeutet
restaurant	restaurant
appearance	erscheinung
as	schnellstmöglich
value	mehrwert
specifically	konkret
description	beschreibung
stunning	atemberaubenden
usb	usb
fault	schuld
wild	wild
pictures	bilder
eur	eur
restoration	wiederherstellung
at	zumindest
layer	schichten
ve	wiener
les	les
kernel	kernel
registered	registrierte
walks	spaziergänge
completed	abgeschlossen
site	website
surface	oberfläche
respected	respektiert
arrangements	vorkehrungen
macedonia	mazedonien
dual	doppelten
turns	dreht
claimed	behauptet
partner	partner
minorities	minderheiten
greater	größere
capture	erfassen
terrorist	terroristische
productivity	produktivität
una	una
perhaps	vielleicht
began	begannen
views	ansichten
administration	administration
roman	römische
member	mitgliedsländern
when	wann
strange	fremden
speaker	redner
geographical	geografischen
largest	größte
underground	u-bahn
party	partei
socialist	sozialistische
gets	bekommt
privileged	bevorzugten
cod	cod
tree	baum
responses	reaktionen
practice	praxis
http	html
context	kontext
solved	gelöst
again	erneut
logic	logik
upon	rufe
effect	effekt
automation	siemens
authors	autoren
compared	verglichen
student	schüler
distinction	unterscheidung
frequently	gestellte
nation	nation
lobby	lobby
warming	erwärmung
destruction	zerstörung
audit	prüfung
expense	lasten
off	off
center	center
fully	voll
nevertheless	nichtsdestotrotz
whole	ganzes
colour	farbe
incredible	unglaublich
well	gut
fighting	kämpfe
thought	dachte
patterns	muster
1	1
command	befehl
likewise	ähnlicher
personnel	personals
firstly	erstens
position	position
audio	audio
arising	entstehenden
drawing	ausarbeitung
stressed	betonte
load	geladen
excessive	übermäßige
looked	sah
less	weniger
moments	momente
boot	booten
accurate	genaue
executive	executive
domestic	inland
obtain	erlangen
detail	detail
inadequate	unzureichend
arriving	ankommen
mistakes	fehlern
books	bücher
fishing	fischfang
seats	sitze
protecting	schutzes
paul	paul
coordination	koordination
web	web
generous	großzügige
rapid	raschen
officially	offiziell
residential	siedlung
supply	versorgungssicherheit
demographic	demografischen
lake	sees
capabilities	fähigkeiten
discuss	besprechen
simple	simple
add	hinzufügen
valid	gültige
nato	nato
attractive	attraktive
citizen	unionsbürger
usage	benutzung
ski	ski
unprecedented	nie
ought	müsste
details	einzelheiten
identical	identisch
tests	tests
increased	erhöhte
provisions	bestimmungen
government	regierung
characters	figuren
1999	1999
increases	erhöht
historic	historischer
five	fünf
know	wissen
burden	belastung
nor	weder
belgium	belgien
taking	ergreift
height	höhe
prominent	herausragende
loss	verlust
necessary	notwendigen
like	gefällt
finnish	finnische
sizes	größen
chairs	vorsitzenden
ring	ring
units	einheiten
taxpayers	steuerzahler
garage	garage
ruling	herrschenden
hosts	gastgeber
payments	zahlungen
lose	verlieren
leaves	verlässt
actors	akteure
works	werken
soft	soft
soviet	sowjetischen
regardless	ungeachtet
replacement	ersatz
amendment	änderungsantrags
exceed	überschreiten
drop	rückgang
could	könnten
classical	klassischen
requested	beantragt
village	village
searching	suche
alive	lebendigen
socialists	sozialisten
platforms	plattformen
growth	wachstums
export	exportieren
choosing	auszuwählen
recommendation	empfehlung
proper	ordnungsgemäße
home	home
empire	reiches
peter	peter
employment	beschäftigung
march	märz
happens	passiert
throughout	gesamten
focused	konzentriert
lead	führen
seminars	seminare
demonstrates	demonstriert
avoid	vermeiden
annex	anhang
eurozone	eurozone
does	gedenkt
passion	leidenschaft
contact	kontaktieren
da	leonardo
leader	marktführer
demonstrated	demonstriert
mode	modus
monuments	sehenswürdigkeiten
noise	lärm
medieval	mittelalterliche
schedule	zeitplan
monetary	geldpolitik
expansion	expansion
ability	fähigkeit
overall	insgesamt
pressure	druck
host	gastgeber
balkans	balkan
prohibited	untersagt
benefit	zugute
although	obgleich
worthy	verdient
described	beschrieben
analyses	analysen
r	r
loans	darlehen
perspectives	vorausschau
gained	gewonnen
about	ungefähr
actual	tatsächlichen
beef	rindfleisch
extension	verlängerung
impose	durchzusetzen
column	spalte
freedom	freiheit
certainty	rechtssicherheit
ecological	ökologische
shipping	versandkosten
hot	heiße
compatible	kompatibel
statement	erklärung
places	orte
insufficient	unzureichende
introduced	eingeführt
swimming	schwimmen
warranty	garantie
equally	gleichermaßen
alliance	alliance
letters	buchstaben
recognise	anerkennen
keeps	hält
previously	zuvor
political	politische
zones	zonen
washington	washington
commitment	bekenntnis
getting	verschlechtert
assess	bewerten
included	inbegriffen
guard	davor
weather	wetter
promise	versprechen
national	nationalen
registration	registrierung
roads	straßen
improved	verbesserte
drafting	ausarbeitung
forget	vergessen
mere	bloße
utility	werkzeug
postal	post
regarded	angesehen
van	van
additional	zusätzlicher
val	val
confident	zuversichtlich
estate	immobilien
housing	gehäuse
zurich	zürich
reduction	reduktion
spots	schwachstellen
1989	1989
continental	festland
intention	absicht
recognised	anerkannt
slovakia	slowakei
inner	inneren
biggest	größte
rcb	die
naturally	selbstverständlich
function	funktion
building	gebäudes
receipt	erhalt
north	north
maintenance	wartung
funds	strukturfonds
brand	marke
agrees	stimmt
stories	geschichten
but	sondern
forward	vorn
volume	volumen
repeated	wiederholten
construction	bau
goals	ziele
	
automated	automatischen
convergence	konvergenz
helpful	hilfreich
highest	höchsten
eat	essen
witness	zeugen
assets	vermögenswerte
count	zählen
constitute	darstellen
§	§
wise	weisen
marquis	red_marquis
evident	offenkundig
whether	ob
dangerous	gefährlich
cells	zellen
official	offiziellen
rooms	nichtraucherzimmer
©	©
signed	unterzeichnet
record	protokoll
below	unten
·	·
°	°
empty	leeren
²	m²
acting	agieren
demonstrate	demonstrieren
problem	problem
pm	uhr
minutes	minuten
display	display
transaction	transaktion
obstacles	hindernisse
bearing	bedenkt
irish	irische
rightly	recht
entering	eingabe
deaths	tote
reservations	vorbehalte
accounts	konten
contribute	beizutragen
combine	kombinieren
inn	inn
highlighted	hervorgehoben
periods	fristen
quotas	quoten
our	unsere
arrival	ankunft
partly	teilweise
recommendations	empfehlungen
authority	autorität
balcony	balkon
mutual	gegenseitigen
avoided	vermieden
48	48
49	49
sexual	sexueller
45	45
percent	prozent
forests	wälder
40	40
commitments	verpflichtungen
old	alte
other	sonstigen
guarantee	garantie
special	special
branch	niederlassung
better	besseres
welcomes	begrüßt
mass	massenvernichtungswaffen
behold	siehe
out	herausfinden
conclusion	schlussfolgerung
album	album
repeat	wiederhole
star	star
monday	montag
class	class
become	geworden
june	juni
shown	gezeigt
thanks	dank
stay	aufenthalts
enlargement	erweiterung
chance	chance
•	•
additionally	zusätzlich
tonnes	tonnen
came	begab
catering	gastronomie
friends	freunde
survey	umfrage
exposure	gefährdung
factors	faktoren
designers	designer
prices	preise
renowned	renommierten
using	verwendung
starting	ausgangspunkt
choices	entscheidungen
entertainment	entertainment
subscribe	abonnieren
rule	rechtsstaatlichkeit
write	schreiben
compete	konkurrieren
pension	pension
rural	ländliche
accidents	unfälle
frankfurt	frankfurt
gardens	gärten
cleaning	reinigung
petitions	petitionen
