en	de
telmisartan	telmisartan
1,4	1,4
1,3	1,3
four	vier
anaemia	anämie
localized	lokalisierte
18a	18a
cytochrome	cytochrom
cyclodextrin	cyclodextrin
hormone	hormons
pigment	pigment
handling	handhabung
medicament	medikaments
bringing	zusammenbringen
polyacrylamide	polyacrylamid
elevations	erhöhungen
implanting	implantieren
pulse	impuls
270	270
second	zweite
miliary	miliartuberkulose
periodontitis	periodontitis
sterile	steriles
fingers	fingern
postoperative	postoperativen
resilient	elastischem
increasing	erhöhung
reporter	reportergen
perforations	perforationen
here	hier
atoms	atomen
reported	berichteten
endoscopic	endoskopischen
mediastinum	mediastinums
lipidic	wasserhaltigen
substance	substanz
k	k
reports	berichte
granulomatosis	granulomatose
symmetrical	symmetrisch
non-ionic	nicht-ionische
millimetres	millimeter
projection	vorsprung
classification	klassifikation
9a	9a
replace	ersetzen
brought	gebracht
anions	anionen
unit	einheit
derivatives	derivaten
dna	dna
backing	rückschicht
t-cell	t-zell
therefore	deshalb
e2	e2
until	solange
successful	erfolgreich
reversibly	reversibel
α-amylase	α-amylase
glass	glas
reversible	reversible
91	91
90	90
excl	ausschl
92	92
95	95
94	94
97	97
circumstances	umständen
intake	nahrungsaufnahme
organopolysiloxane	organopolysiloxan
blade	klinge
temperatures	temperaturen
plunger	stößel
example	beispiel
immunising	immunisierung
titanium	titan
caution	vorsicht
absolute	absoluten
preferably	vorzugsweise
drying	trocknen
damage	schädigung
machine	maschine
leiomyoma	leiomyom
aldehyde	aldehyd
saline	kochsalzlösung
modulation	modulation
atherectomy	rotierenden
types	typen
effective	effektive
recombination	rekombination
discontinued	abgesetzt
e172	-oxid
e171	171
orally	oral
wing	flügel
vary	variieren
1-14	1-14
mabthera	mabthera
1-11	1-11
1-10	1-10
1-13	1-13
1-12	1-12
activating	aktivieren
ready-to-use	gebrauchsfertigen
ligand	ligand
fit	passt
auditory	akustisch
fig	fig.
oligosaccharide	oligosaccharid
handpiece	handstück
miscible	mischbaren
hypoxia	hypoxie
colourless	farblose
silver	silber
structural	strukturelle
represents	wiedergibt
ethylenically	ethylenisch
ankle	knoechels
coronavirus	coronavirus
stabiliser	stabilisator
garment	bekleidungsstück
platelets	blutplättchen
double-stranded	doppelsträngigen
displacement	verschiebung
epidural	epidurale
parasites	parasiten
contracting	vertragsstaaten
anaphylactoid	anaphylaktoide
substantially	wesentlichen
stabilised	stabilisierten
rs	rs
helically	spiralförmig
recognising	erkennen
copolymers	copolymeren
dsm	dsm
ra	ra
foundation	make-up
sensory	sensorische
sensors	sensoren
obliterans	obliterans
chlorine	chloratom
r4	r4
r5	r5
atc	atc-code
r2	r2
r3	r3
diabetic	diabetischer
silicon	silicium
atp	atp
r-	r-
steroids	steroiden
vitro	vitro
channels	kanäle
178	178
176	176
175	175
174	174
172	172
171	171
170	170
seizures	krampfanfälle
xii	xii
engagement	eingriff
codons	codons
mastitis	mastitis
needed	nötig
keratinocytes	keratinozyten
listed	aufgeführten
legs	beinen
ranging	mengenanteil
fibrous	fasermaterial
prosthetic	prothetische
integrally	integral
palsy	zerebralparese
sulphur	schwefel
showed	zeigten
regulator	regler
pneumonia	pneumonie
feeling	gefühl
lamivudine	lamivudin
myositis	myositis
spectrum	spektrum
igf-i	igf-i
releases	freisetzt
person	person
responsible	verantwortlich
metallic	metallische
preservatives	konservierungsmitteln
recommended	empfohlene
causing	veranlassen
absorbed	absorbiert
orthosis	orthese
igf-1	igf-1
object	objekt
immunogenicity	immunogenität
mouth	mund
retaining	halteelement
introna	introna
episode	episode
detectors	detektoren
rotary	rotierende
mating	passenden
polypropylene	polypropylen
reactor	reaktor
insects	insekten
soluble	löslicher
ulcer	duodenalulkus
kallikrein	kallikrein
kinase	kinase
rice	reis
plate	platte
umbilical	nabelschnur
psychiatric	psychiatrische
pocket	tasche
cushion	kissen
tungsten	wolfram
staphylococcal	staphylokokken
rectal	rektale
dipping	eintauchen
patch	pflasters
release	freisetzung
sensitivity	empfindlichkeit
radius	radius
cloning	klonierung
best	besten
4-fluorophenyl	4-fluorphenyl
rings	ringe
conductive	leitfähige
invention	erfindung
monohydrate	lactose-monohydrat
extend	erstrecken
nature	natur
tert-butyl	-butyl
eukaryotic	eukaryotischen
extent	ausmaß
tendons	sehnen
carbon	kohlenstoff
roller	walze
myoclonic	myoklonische
accident	verkehrs
isopropyl	isopropyl
heating	erhitzen
polyesters	polyestern
genus	gattung
adapted	angepasst
active	aktiven
pregnancy	schwangerschaft
250	250
256	256
254	254
watercraft	wasserfahrzeuges
union	union
humectant	feuchthaltemittel
.	.
extraction	extraktion
much	viel
empyema	empyem
integrin	integrin
progenitor	vorläuferzellen
pancreas	pankreas
arteriovenous	arteriovenoese
phenytoin	phenytoin
life	lebensqualität
longitudinally	längsrichtung
fibroblast	fibroblasten-wachstumsfaktor
erythema	erythem
child	kindes
inch	inch
calcium	calcium
preselected	vorgewählten
viii	viii
polysaccharide	polysaccharids
perineal	dammriss
actuated	betätigt
hypoplasia	hypoplasie
severity	schweregrad
trypanosomiasis	trypanosomiasis
dryness	trockenheit
-s-	-s-
european	europäische
myocardial	myokardinfarkt
exfoliative	exfoliativa
adenoma	adenom
downwardly	unten
disseminated	disseminierte
-so	-so
mucopolysaccharidosis	mukopolysaccharidose
quantitative	quantitativen
diastereoisomers	diastereoisomere
interferon	interferon
rotated	gedreht
rotates	dreht
previous	früheren
atrial	atrialen
acetylsalicylic	acetylsalicylsäure
irradiated	bestrahlt
had	hatte
thickening	verdickungsmittel
topical	topische
cations	kationen
has	hat
elevation	erhebung
fracture	fraktur
survival	überleben
possible	möglichen
indicative	angibt
birth	geburtsverletzung
occurring	vorkommenden
psychological	psychologische
articulated	gelenkig
tapering	verjüngenden
steps	schritte
malnutrition	mangelernaehrung
effusion	erguss
beneficial	nützliche
right	rechten
old	alt
people	personen
for	zur
bottom	bodens
periphery	peripherie
syphilis	syphilis
insipidus	insipidus
varicose	varizen
dental	dentalen
necrolysis	nekrolyse
binder	bindemittels
substituted	substituiertes
filaments	filamente
emits	emittiert
restlessness	unruhe
erythematosus	erythematosus
neutralising	neutralisieren
adipose	fettgewebe
o	o
heteroatoms	heteroatome
slightly	geringfügig
tel	tel
spores	sporen
reducing	reduzierende
urticaria	urtikaria
novo	novo
fabric	vliesstoff
aralkyl	aralkyl
support	stütze
width	breite
grasping	ergreifen
resulted	führte
selection	selektion
therapeutically	therapeutisch
alloys	legierungen
perfumes	parfums
regenerating	regeneration
forming	ausbilden
incorporation	einbau
colourants	farbstoffen
extremity	extremität
inside	innern
devices	vorrichtungen
complications	komplikationen
silicic	kieselsäure
151	151
passenger	fahrgast
juvenile	juvenile
152	152
155	155
154	154
157	157
156	156
158	158
congenita	congenita
tooth	zahns
melanoma	melanom
floor	bodens
role	rolle
roll	walze
's	alzheimer
models	modelle
ointment	salbe
cleaved	gespalten
15a	15a
variable	variable
transporter	transporter
99	99
98	98
aerobic	aeroben
fastener	befestigungselement
time	zeit
protozoal	protozoen
urinary	harninkontinenz
measurements	messungen
polypeptides	polypeptiden
chain	kette
*rcb*	*rcb*
activated	aktivierten
post-traumatic	posttraumatische
gallbladder	gallenblase
activates	aktiviert
hole	loch
amplification	amplifikation
96	96
choice	wahl
exact	genaue
minute	minute
eosinophilia	eosinophilie
eosinophilic	eosinophile
prevent	verhindern
occurrence	auftretens
findings	befunde
parvovirus	parvovirus
agonists	agonisten
depressions	vertiefungen
axes	achsen
melt	schmelze
current	stroms
streptomyces	streptomyces
annular	ringförmige
alone	alleine
along	entlang
anchoring	verankerungselement
studied	untersucht
atrioventricular	atrioventrikulaerer
studies	studien
isoelectric	isoelektrischen
macromolecule	makromolekül
toxoplasmosis	toxoplasmose
amphoteric	amphoteren
positive	positiven
anatomical	anatomischen
opposed	gegenüberliegende
films	folien
introducing	einführen
tinea	tinea
ovine	schaf
polypeptide	polypeptids
opioids	opioide
hydrochloride	hydrochlorid
facilitating	erleichterung
abortion	abort
cutaneous	kutanes
values	werten
following	folgende
238	238
allowed	gelassen
234	234
236	236
230	230
232	232
litre	liter
monitoring	überwachung
septic	septische
divided	unterteilt
warfarin	warfarin
immune	immunantwort
s.	s.
s-	s-
optimal	optimale
parameter	parameters
applications	anträge
antiperspirant	schweißhemmende
cardiac	kardialen
such	derartigen
peritoneal	peritonealdialyse
data	daten
contraindicated	kontraindiziert
stress	stress
natural	natürliches
xanthan	xanthangummi
wheelchair	rollstuhl
sp	sp
sclerosis	sklerose
si	si
so	so
swollen	geschwollene
sc	sc
sa	sa
se	se
sd	sd
wavelengths	wellenlängen
tts	tts
epilepsy	epilepsie
feature	merkmal
course	verlauf
episodes	episoden
thumb	daumen
decreases	abnimmt
suspension	suspension
thereby	wodurch
insomnia	schlaflosigkeit
exon	exon
maintaining	aufrechterhaltung
procaryotic	prokaryontischen
prophylaxis	prophylaxe
purinoceptor	purinerge
alginate	alginat
coagulation	koagulation
veins	venen
capitis	capitis
crushing	quetschverletzung
bovine	rind
sexually	sexuell
methotrexate	methotrexat
karyotype	karyotyp
latvija	latvija
oedema	ödeme
vibrio	vibrio
container	behälters
paroxysmal	paroxysmale
hybridoma	hybridom
trauma	trauma
formula	formel
hcl	hcl
chemically	chemisch
million	millionen
possibility	möglichkeit
inwardly	einwärts
complicated	kompliziert
benzoyl	benzoyl
anchor	anker
inhaler	inhalator
training	training
plasminogen	plasminogenaktivator
distal	distalen
parkinson	parkinson
one	eins
gases	gasen
open	offenen
operable	betreibbar
quality	qualität
indicate	anzuzeigen
2	2
operably	operabel
structures	strukturen
transgene	transgen
representing	repräsentieren
hyperplasia	hyperplasie
depressed	depressiv
hypoglycaemia	hypoglykämie
ablation	ablation
sclerosing	sklerosierende
emea	emea
inhibiting	inhibierung
preservative	konservierungsmittel
neutropenia	neutropenie
take	einzunehmen
altered	veränderten
opposite	entgegengesetzten
buffer	puffer
molecule	molekül
povidone	povidon
xylanase	xylanase
knee	knies
paget	paget-krankheit
inserted	inseriert
ankylosing	ankylosans
operate	arbeiten
average	durchschnittliche
infections	infektionen
drive	antriebselement
salt	salzes
hydroxypropyl	hydroxypropylcellulose
stimulator	stimulator
dimensioned	dimensioniert
oestrogens	östrogene
friction	reibung
slot	schlitz
fibre	faser
slow	langsamer
sterilised	sterilisiert
phospholipids	phospholipiden
equipped	ausgerüstet
excision	exzision
propyl	propyl
carboxymethylcellulose	carboxymethylcellulose
genera	gattungen
outlet	auslass
recombinant	rekombinanten
parasitic	parasitäre
saliva	speichel
esophageal	oesophageales
lopinavir	lopinavir
where	wo
hinged	angelenkt
vision	sehen
gout	gicht
surgery	chirurgie
compounds	verbindungen
sites	lokalisationen
vaccines	impfstoffen
affecting	auswirkung
tocopherol	tocopherol
impregnated	imprägniert
vertical	vertikalen
screen	sieb
detachably	lösbar
concentrate	konzentrat
brassica	brassica
suppressed	unterdrückt
concentrated	konzentrierten
circumference	umfangs
many	viele
s	s
expression	expression
storing	speichern
3000	3000
dislocation	luxation
hyperlipidaemia	hyperlipidämie
microparticle	mikropartikel
toothpaste	zahnpasta
locally	lokal
breath	kurzatmigkeit
incubation	inkubation
combined	kombinierten
deformable	verformbare
reflective	reflektierende
reflex	reflex
enable	ermöglichen
2-	2-
formed	gebildete
dermatologically	dermatologisch
psychotherapy	psychotherapie
diffuse	diffuse
hypertrophy	hypertrophie
situation	situation
microporous	mikroporösen
lysosomal	lysosomale
pericarditis	perikarditis
iva	iva
hydrolysable	hydrolysierbaren
arteriosus	arteriosus
analyte	analyt
ambient	umgebungstemperatur
engages	eingreift
laceration	dammriss
emulsions	emulsionen
subunit	untereinheit
visually	visuell
wires	drähte
edges	kanten
costs	kosten
dimension	dimension
effects	effekte
216	216
214	214
215	215
212	212
213	213
210	210
211	211
being	lebewesens
218	218
weekly	wöchentlich
pastoris	pastoris
interstitial	interstitielle
instrument	instruments
silicones	siliconen
metalloproteinase	metalloproteinase
multi-layer	mehrschichtige
around	herum
vagus	vagus
6-	6-
traffic	verkehrsunfall
atcc	atcc
vacuum	vakuum
calculate	berechnen
meaning	bedeutung
thyroiditis	thyreoiditis
amputation	amputation
62	62
clay	ton
colon	kolons
glycol	polyethylenglykol
stationary	stationären
intestinal	intestinales
interleukin	interleukin
adenoid	zystisches
dimensions	abmessungen
cavity	hohlraums
tube	rohr
biased	vorgespannt
scientific	wissenschaftlichen
power	leistung
uterine	uterine
retains	beibehält
retinoid	retinoid
ratios	verhältnissen
mmol	mmol
ace	ace-hemmer
package	verpackung
industry	industrie
meal	mahlzeit
tumor	tumormarker
act	act
mean	mittlere
burning	brennen
image	bildes
pyrimidine	pyrimidin
24a	24a
fluorine	fluoratom
het	het
bristles	borsten
meals	mahlzeiten
tonsils	tonsillen
italia	italia
sealed	versiegelt
series	serie
viscous	viskose
complete	komplette
mammals	säugetieren
follicular	follikulaeres
elimination	elimination
impedance	impedanz
mice	mäusen
with	mit
pull	ziehen
october	oktober
dispensing	abgeben
aa	aa
ab	ab
ag	ag
certain	bestimmter
al	al
an	isoliertes
as	wie
ar	ar
hypertension	bluthochdruck
at	at
formulation	formulierung
cream	creme
aromatic	aromatischen
phenol	phenol
spatial	räumlichen
polyvinylpyrrolidone	polyvinylpyrrolidon
fluorinated	fluorierte
annex	anhang
monocyte	monocyte
a.	a.
a1	a1
a2	a2
gastric	magen-
acids	säuren
mask	maske
kilogram	kilogramm
immunoglobulin	immunglobulins
mass	maße
thrombin	thrombin
dyes	farbstoffen
cps	cps
original	ursprünglichen
externally	extern
influenza	influenza
caused	verursachten
ceramic	keramische
papilloma	papillomavirus
macroglobulinemia	makroglobulinaemie
puregon	puregon
causes	ursachen
content	gehalt
zwitterionic	zwitterionischen
to	bis
chewing	kaugummi
dressing	verband
tb	tb
tc	tc
degeneration	degeneration
subunits	untereinheiten
dispersions	dispersionen
strand	strang
humira	humira
cable	kabel
borrelia	borrelia
t4	t4
t1	t1
t.	t.
adjust	einzustellen
small	kleines
mammal	säugetier
antibiotic	antibiotische
conjunctival	bindehaut
194	194
190	190
192	192
pass	passieren
poliomyelitis	poliomyelitis
section	abschnitt
method	methode
contrast	kontrastmittel
full	voller
implantable	implantierbaren
urethritis	urethritis
vomiting	erbrechen
hours	stunden
divalent	zweiwertige
welded	verschweißt
experience	erfahrung
prior	vor
periodic	periodischen
social	soziale
action	einwirkung
via	via
followed	gefolgt
vii	vii
liprolog	liprolog
5-cyclopropyl-1h-pyrazol-3-yl	5-cyclopropyl-1h-pyrazol-3-yl
thermostable	thermostabile
850	850
fragrance	duftstoff
6	6
metformin	metformin
more	stärker
proliferative	proliferative
door	tür
initiated	eingeleitet
substances	substanzen
company	unternehmen
tested	getestet
solvates	solvate
haemodialysis	hämodialyse
exposing	aussetzen
pivotably	schwenkbar
endpoint	endpunkt
sterol	sterol
male	männlichen
helicobacter	helicobacter
antagonists	antagonisten
stated	verfalldatum
states	vertragsstaaten
sense	sinne
bonded	verklebt
axis	achse
information	information
respective	jeweiligen
plant	pflanze
intended	bestimmt
axilla	axilla
variant	variante
treatments	behandlungen
plane	ebene
waves	wellen
thickener	verdickungsmittel
peritonitis	peritonitis
-5-	-5-
nephritic	nephritisches
immunisation	immunisierung
paper	papier
signs	anzeichen
nephritis	nephritis
subarachnoid	subarachnoidalblutung
its	seines
rapidly	rasch
thereon	darauf
stricture	striktur
symptoms	symptomen
bypass	bypass
reciprocating	hin-
paraplegia	paraplegie
*rsqb*	&#93;
dermatoses	dermatosen
designation	bezeichnung
always	immer
found	gefunden
physiologically	physiologisch
reactions	reaktionen
contiguous	zusammenhängende
reduce	vermindern
doses	dosen
operation	betriebs
penicillin	penicillin
psychology	psychologie
spondylitis	spondylitis
diverticulum	divertikel
occurs	auftritt
imaging	bildgebende
murmur	herzgeraeusch
schistosomiasis	schistosomiasis
pairs	paare
carboxy	carboxy
positioning	positionierung
retainer	halters
w	w
major	major
thereafter	danach
number	anzahl
preservation	konservierung
guar	guargummi
plasticiser	weichmacher
etoricoxib	etoricoxib
ciprofloxacin	ciprofloxacin
introduction	einführung
adenovirus	adenovirus
genetically	genetisch
molecular	molekularen
relationship	beziehung
immediate	kleinen
inactivating	inaktivierung
linoleic	linolsäure
diffusion	diffusion
polysaccharides	polysacchariden
syringes	fertigspritzen
determined	ermittelten
oestradiol	estradiol
defect	defekt
pedestrian	fußgänger
conjugate	konjugats
also	ebenfalls
internal	internen
nasal	nasale
virus	virus
synthesised	synthetisiert
directive	richtlinie
cover	abdeckung
cultivating	kultivieren
barrel	zylinders
gaba	gaba
gold	gold
evaporation	verdampfen
haematopoietic	hämatopoetischen
indicator	indikator
cvmp	cvmp
emulsifier	emulgator
removably	entfernbar
enzyme	enzyms
cassette	kassette
removable	entfernbare
factor	faktors
columns	spalten
trehalose	trehalose
dependent	abhängigen
beams	strahlen
peginterferon	peginterferon
preparing	herstellen
allergen	allergen
adhered	haftet
trifluoromethyl	trifluormethyl
saccharose	saccharose
campylobacter	campylobacter
inducible	induzierbaren
sleeve	muffe
cleaving	spalten
goitre	struma
aryl	aryl
methacrylic	methacrylsäure
uveitis	uveitis
set	satzes
ser	ser
seq	seq
312	312
310	310
316	316
sex	geschlecht
see	siehe
migration	migration
outwardly	außen
contour	kontur
vitamins	vitaminen
currently	derzeit
diluted	verdünnt
respectively	beziehungsweise
acidic	sauren
available	verfügbaren
targeted	gezielte
eustachian	tuba
selectively	selektiv
interface	grenzfläche
vesicles	vesikel
last	zuletzt
connection	verbindungsanordnung
whole	vollblut
load	last
corresponds	entspricht
hollow	hohle
solute	gelösten
agents	agentien
gonococcal	gonokokken
initiation	initiationsfaktor
xaa	xaa
counselling	beratung
representative	repräsentativ
pacemaker	schrittmacher
ligands	liganden
hardness	härte
haemolytic	hämolytische
gender	geschlecht
alkenyl	alkenyl
uncertain	unsicheren
straight	geraden
expanded	expandierten
technical	technische
pressed	gepresst
evaluating	auswertung
nucleotides	nucleotiden
hyperactivity	hyperaktivität
binding	bindende
abacavir	abacavir
elevated	erhöhten
shorter	kürzer
myotonic	myotone
radionuclide	radionuklid
deformity	deformitaet
levels	plasmaspiegel
opinion	gutachten
focal	fokale
infertility	unfruchtbarkeit
stents	stents
inflation	aufblasen
regulating	regulieren
clearance	clearance
comprise	umfassen
amp	amp
contracture	kontraktur
assaying	testen
slidably	gleitend
chest	brustkorb
signals	signalen
musculoskeletal	skelettsystems
location	ort
input	eingang
slidable	verschiebbaren
serotype	serotyp
suffering	leidet
outcomes	endpunkte
projects	vorsteht
d	d
spine	wirbelsäule
spina	spina
retrovirus	retrovirus
fibroblasts	fibroblasten
-3-	-3-
continue	fort
microcapsules	mikrokapseln
disorder	störung
methods	methoden
spring	feder
b.	b.v.
oval	ovale
b1	b1
b2	b2
veterinary	veterinärmedizinische
convulsions	krämpfe
inclination	neigung
inserting	einfügen
be	be
bifida	bifida
bp	bp
br	br
relating	beziehen
by	indem
analysing	analysieren
wrinkles	falten
secretory	sekretorische
gram-negative	gramnegative
cmax	cmax
anterior	anteriore
repair	reparatur
into	hinein
helical	spiralförmigen
integral	integral
locus	locus
appropriate	geeignete
mitochondrial	mitochondriale
primarily	hauptsächlich
insecticide	insektizid
lactide	lactid
methylene	methylen
β-	β-
specifically	spezifisch
adenocarcinoma	adenokarzinom
:	:
opens	öffnet
elsewhere	anderenorts
inches	zoll
retina	netzhaut
initiator	initiator
link	verbindungsglied
atom	stickstoffatom
line	linie
chloride	chlorid
uv	uv-strahlung
up	schminken
cis	cis
uk	uk
continuously	kontinuierlich
paroxetine	paroxetin
defined	definiert
m	m
influence	einfluss
unsaturated	ungesättigten
defines	festlegt
fixing	fixieren
analgesics	analgetika
preventing	verhinderung
adjuvant	adjuvans
substituents	substituenten
coded	kodierten
degenerative	degenerativen
elements	elementen
provided	vorausgesetzt
heteroaryl	heteroaryl
suppression	unterdrückung
sides	seiten
transluminal	transluminale
age	alter
thrombosis	thrombose
levodopa	levodopa
beverage	getränk
retardation	wachstumsverzoegerung
having	aufweisenden
code	code
partial	partiellen
iib	iib
results	ergebnissen
nanoparticle	nanopartikel
concerned	betroffenen
young	jungen
oesophageal	oesophageales
indicating	angibt
mixing	mischen
continued	fortgesetzt
wipe	tuch
myelopathy	myelopathie
transmission	übertragung
trp	trp
obesity	fettsucht
encloses	umschließt
biomass	biomasse
enclosed	eingeschlossen
wheat	weizen
oligomers	oligomeren
index	index
apparatus	apparat
expressed	exprimierten
hereditary	hereditaere
flowing	fließt
expresses	exprimiert
x-linked	x-chromosomal-gebundene
advantageously	vorteilhafterweise
proliferation	proliferation
leg	unterschenkels
actuation	betätigung
punch	stempel
gilles	gilles
delivering	abgeben
bromine	brom
leu	leu
invented	phantasiebezeichnung
great	transposition
engage	eingreifen
receive	aufzunehmen
involved	beteiligt
polystyrene	polystyrol
acetyltransferase	acetyltransferase
resulting	resultierende
insulin	insulin
contaminants	verunreinigungen
makes	macht
lymphocytic	lymphozytische
330	330
332	332
piperidine	piperidin
perfusion	perfusion
illegal	illegal
next	nächste
lock	verriegeln
thickeners	verdickungsmitteln
pharmacologically	pharmakologisch
occurred	trat
carrying	tragenden
labelled	markierten
baby	baby
resection	resektion
animals	tieren
this	dies
slit	schlitzes
hydrolysis	hydrolyse
thin	dünnen
of	von
4-chlorophenyl	4-chlorphenyl
mannitol	mannit
bent	gebogen
process	prozess
pelvic	becken
purposes	zwecke
high	hohen
coenzyme	coenzym
bend	biegung
pelvis	beckens
rods	stäbchen
mix50	mix50
hydrophilic	hydrophile
endoscopy	endoskopie
coaxially	koaxial
delay	verzögerung
animal	tierischen
hormones	hormonen
venous	venösen
blocks	blockiert
clostridium	clostridium
pasteur	pasteur
pigs	schweinen
fits	passt
marrow	knochenmark
intraepithelial	intraepitheliale
microbial	mikrobiellen
element	element
allow	erlauben
alloy	legierung
volunteers	probanden
thigh	oberschenkel
produces	produziert
vaccinated	geimpft
move	bewegen
produced	produzierten
motorcycle	motorradfahrer
rasilez	rasilez
gonadotropin	choriongonadotropin
operative	operativen
progeny	nachkommen
mellitus	mellitus
diluents	verdünnungsmitteln
degrees	grad
communication	kommunikation
derivative	derivats
therefor	hierfür
physicians	ärzte
endoscope	endoskops
detergents	wasch-
stabilise	stabilisieren
rotation	drehung
transparent	transparenten
concave	konkave
kpa	kpa
vibrations	schwingungen
electrically	elektrisch
accompanied	begleitet
homogeneous	homogenen
heated	erhitzt
deficiency	mangel
frequency	frequenz
static	statischen
irritation	reizung
meth	meth
matrix	matrix
'	'
valve	ventils
bad	bad
mediated	vermittelten
luteinising	luteinisierendes
interactions	wechselwirkungen
-1-	-1-
testosterone	testosteron
regulatory	regulatorischen
could	könnten
compulsive	zwanghafte
length	länge
stimulate	stimulieren
450	450
collagen	collagen
hydrogenated	hydriertes
metering	dosiervorrichtung
two-	dreiraedrigem
system	system
bromide	bromid
lumen	lumens
peripheral	peripheren
painful	schmerzhafte
stomach	magen
alopecia	alopezie
drape	tuch
hemophagocytic	hämophagozytäre
actuator	stellglied
retraction	zurückziehen
steel	stahl
non-b	non-b
non-a	non-a
negatively	negativ
allergic	allergischen
result	ergebnis
collecting	sammeln
n-terminal	n-terminalen
psychoses	psychosen
gently	vorsichtig
liner	auskleidung
clearly	eindeutig
viewed	gesehen
femoral	femoralis
4000	4000
mechanism	mechanismus
septal	septumdefekt
incorporating	einbau
peroxidase	peroxidase
soap	seife
calculus	stein
oncogene	onkogen-protein
bicyclic	bicyclische
hydroxyl	hydroxyl
device	vorrichtung
segment	segments
subsequently	anschließend
centimetres	zentimeter
05	05
hydrocephalus	hydrozephalus
face	gesicht
mechanical	mechanischen
fact	tatsache
atmosphere	atmosphäre
inflammations	entzündungen
jaw	backe
technetium	technetium
should	sollten
terminal	terminalen
tape	band
molecules	molekülen
handle	griff
bonds	bindungen
neisseria	neisseria
exchanger	wärmetauscher
familial	familiärer
sinus	sinus
antagonist	antagonist
metabolite	metabolit
circulation	kreislauf
h	h
comprising	umfassend
unsubstituted	unsubstituiertes
frame	rahmens
temporarily	vorübergehend
exerted	ausgeübt
electrode	elektrode
packed	verpackt
coils	spulen
wire	drahtes
hemolytic	haemolytische
nuclear	nukleäre
zeolite	zeolith
stearic	stearinsäure
methionine	methionin
membrane	membran
piston	kolbens
ends	enden
configuration	konfiguration
drum	trommel
isopropanol	isopropanol
la	la
drug	arzneistoff
figures	figuren
tlf	tlf
nevus	nävus
adjusted	eingestellt
ch	ch
co	co
cn	cn
cm	cm
cl	cl
ca	ca
cf	cf
ce	klassifizierten
reconstitution	rekonstitution
ataxia	ataxie
cr	cr
cp	cp
chromium	chrom
cu	cu
ct	ct
8.0	8,0
8.5	8,5
genetic	genetischen
waste	abfall
antifungal	fungizide
acyl	acyl
c.	c.
lymphoid	lymphoide
c2	c2
c1	c1
laser	laser
sustained-release	verzögerter
pharmacokinetic	pharmakokinetische
terephthalate	polyethylenterephthalat
threaded	gewinde
vi	vi
delaying	verzögerung
site	bindungsstelle
conditioning	konditionierung
copd	copd
situ	situ
carbohydrates	kohlenhydrate
infarction	myokardinfarkt
antidiabetic	antidiabetika
ball	kugel
drink	getränken
phe	phe
4.6	4.6
identity	identität
diabetes	diabetes
lupus	lupus
colour	farbe
polyp	polyp
chemokine	chemokin
administered	verabreichten
1.25	1,25
358	358
less	weniger
rubber	gummi
luciferase	luciferase
somatotropin	somatotropin
narrowing	verengung
arrest	herzstillstand
valid	unternehmen
cosmetics	kosmetika
wet	feuchten
increased	erhöhtes
increases	zunimmt
five	fünf
atrophy	atrophie
cerevisiae	cerevisiae
placenta	placenta
accelerating	beschleunigung
parasite	parasiten
alkali	alkali-
₇	r₇
mhz	mhz
nerves	nerven
neutrophils	neutrophile
sprain	verstauchung
therapeutic	therapeutisches
opioid	opioide
indications	indikationen
identified	identifizierten
252	252
₁	r₁
transport	transport
sufficiently	ausreichend
avoid	vermeiden
does	wirkt
chelating	chelatbildner
macrophages	makrophagen
selecting	auswählen
cellulose	zellulose
pressure	druckes
abdominal	abdominale
vs.	vs.
stage	stadium
iris	iris
hydrops	hydrops
anaplastic	anaplastisches
seeds	samen
contractions	kontraktionen
assess	beurteilen
lung	lunge
cultivated	kultiviert
terminated	beendet
concentrically	konzentrisch
housing	gehäuse
trigger	auslöser
terminates	endet
9.5	9,5
specimens	untersuchungsmaterialien
naturally	natürlich
function	funktion
	
overlapping	überlappenden
intracranial	intrakranieller
construction	konstruktion
rectum	rektum
count	thrombozytenzahl
¬	¬
®	®
smooth	glatten
reinforcement	verstärkung
µ	µ
·	·
°	°
±	±
²	r²
³	r³
problem	problem
adsorbed	adsorbiert
bearing	lager
condition	zustands
epithelial	epithelzellen
inj	verl
effected	bewirkt
compared	verglichen
rhodococcus	rhodococcus
tubular	röhrenförmige
hpv	hpv
planar	eben
quantities	mengen
repeat	wiederholen
propionic	propionsäure
idiopathic	idiopathischer
vein	vene
exposure	exposition
risperdal	risperdal
apertures	öffnungen
status	status
silica	kieselsäure
ischaemic	ischämischen
ischaemia	ischämie
magnetic	magnetischen
ectodermal	ektodermale
blisters	blisterpackungen
dysplasia	dysplasie
physiological	physiologischen
saccharide	saccharid
humerus	humerus
blanket	decke
replication	replikation
cml	cml
progression	progression
hybridisation	hybridisierung
humidity	feuchtigkeit
disc	bandscheibe
cmv	cmv
insertable	einführbar
machines	maschinen
established	belegt
disk	scheibe
filtration	filtration
+	+
bipolar	bipolaren
reconstruction	rekonstruktion
consisting	bestehend
told	arztes
polarity	polarität
simultaneously	gleichzeitig
residual	restlichen
localisation	lokalisierung
protection	schutz
paraffin	paraffin
obtained	erhaltene
gln	gln
study	studie
viia	viia
gly	gly
conjunctiva	bindehaut
glu	glu
⁶	r⁶
diameter	durchmessers
⁴	r⁴
⁵	r⁵
modulates	moduliert
⁸	r⁸
highly	stark
-nh-	-nh-
modulated	moduliert
total	gesamtmenge
linearly	linear
transformant	transformante
negative	negativen
substitutions	substitutionen
program	programm
alkylene	alkylen
administering	verabreichen
carboxymethyl	carboxymethylcellulose
fractions	fraktionen
tolerated	vertragen
pertussis	pertussis
infusion	infusion
curvature	krümmung
ureter	harnleiters
n-propyl	n-propyl
blocking	blockierung
rifampicin	rifampicin
ethoxy	ethoxy
1997	1997
permits	zulässt
1998	1998
work	arbeit
mammalian	säugerzellen
oxide	oxid
tnf	tnf
wort	johanniskraut
encephalomyelitis	enzephalomyelitis
indicated	indiziert
transfecting	transfektion
nozzle	düse
550	550
intramedullary	marknagel
woman	frau
endometrial	endometriums
carriers	trägern
provide	bereitzustellen
methanol	methanol
tympanic	trommelfells
fever	fieber
transforming	transformieren
agarose	agarose
movable	bewegbare
patella	patella
movably	beweglich
displaceable	verschiebbaren
arch	bogen
leishmania	leishmania
green	grüne
μ	μ
order	reihenfolge
ampoules	ampullen
6.6	6.6
6.5	6,5
12.5	12,5
6.0	6,0
semipermeable	semipermeable
bubbles	blasen
somnolence	somnolenz
galenic	galenische
hybridises	hybridisiert
encapsulated	eingekapselt
production	produktion
forceps	zange
carton	faltschachtel
versus	versus
then	dann
them	zusammenstellungen
affected	betroffen
remission	remission
fragment	fragment
safe	sicheren
reagent	reagenz
penetration	eindringen
anion	anion
oxygen	sauerstoff
echocardiography	echokardiografie
classified	klassifiziert
paraesthesia	paraesthesie
l	l
bacterium	bakterium
mrna	mrna
370	370
372	372
hybridising	hybridisieren
train	eisenbahnfahrzeug
pigments	pigmenten
network	netzwerk
vessels	gefäße
medicine	medizin
forth	dargelegt
sliding	gleiten
wearer	trägers
barrier	barriere
standard	standard
fastening	befestigungssystem
detecting	nachweisen
recovering	gewinnen
incorporated	inkorporiert
render	machen
potentials	potentiale
pegintron	pegintron
another	anderes
radiolabelled	radioaktiv
thick	dick
electronic	elektronischen
approximately	annähernd
glutaraldehyde	glutaraldehyd
john	johanniskraut
dogs	hunden
intestine	duenndarms
enhancing	verstärkung
pharyngitis	pharyngitis
target	target
gp120	gp120
seated	sitzt
binds	bindet
merck	merck
cellularity	mischtyp
iron	eisen
ribonucleoproteins	ribonukleoproteine
bronchitis	bronchitis
manner	weise
contents	inhalt
strength	festigkeit
pleural	pleura
latter	letzteren
adaptor	adapter
subjects	probanden
forces	kräfte
mutants	mutanten
alginic	alginsäure
viscosity	viskosität
reticulum	retikulum
involving	beteiligung
germany	deutschland
phase	phase
assessed	bewertet
adenine	adenin
calculated	berechneten
leaflet	gebrauchsinformation
bracket	klammer
d.	d.
d-	d-
7.0	7,0
7.5	7,5
d2	d2
d3	d3
d1	d1
latent	latente
dermatitis	kontaktdermatitis
screening	screenen
personality	persoenlichkeitsstoerung
thienyl	thienyl
do	dürfen
dl	dl
dk	dk
di	di
de	de
preferred	bevorzugte
degradation	abbau
dr	dr
covering	abdeckt
heterocyclic	heterocyclischen
410	410
412	412
steam	dampf
reacted	umgesetzt
observed	beobachteten
histiocytoma	histiozytom
depends	hängt
projections	vorsprüngen
cattle	rind
optimum	optimale
techniques	techniken
away	weg
glutamine	glutamin
we	wir
packaged	verpackt
benzalkonium	benzalkoniumchlorid
linkage	verknüpfung
extracorporeal	extrakorporalen
received	empfangenen
essentially	wesentlichen
ile	ile
neurokinin	neurokinin
receives	empfängt
receiver	empfänger
exceeds	überschreitet
tone	muskeltonus
trunk	rumpf
codon	codon
mutations	mutationen
seizure	krampfanfall
plantar	babinski
flexible	flexiblen
dichloromethane	dichlormethan
droplets	tröpfchen
ciclosporin	ciclosporin
polyposis	polyposis
carbamazepine	carbamazepin
0.15	0,15
0.10	0,10
applied	aufgebrachten
cytotoxic	cytotoxische
inhibit	hemmen
solvate	solvats
air	luft
aim	aufgabe
aid	hilfe
property	eigenschaft
cylinder	zylinder
glutamic	glutaminsäure
tissue	gewebes
cone	konus
percutaneous	perkutanen
perform	auszuführen
recurrent	rezidiv
atopic	atopische
plates	platten
lithium	lithium
sulfoxide	dimethylsulfoxid
wheel	rad
independent	unabhängige
pylori	pylori
rail	schiene
hand	hand
osteosynthesis	osteosynthese
polytetrafluoroethylene	polytetrafluorethylen
catheter	katheters
glp-1	glp-1
prescribed	verschrieben
kept	aufbewahrt
whereby	wodurch
hypothalamic	hypothalamus
thr	thr
compartments	abteilungen
contact	kontakt
the	die
endometriosis	endometriose
stringent	stringenten
cisplatin	cisplatin
electronically	elektronisch
thyroid	schilddruese
cervix	cervix
passive	passive
neoplasm	neoplasma
transformed	transformierten
openings	öffnungen
plasma	plasma
usable	verwendbaren
rna	rna
water-insoluble	wasserunlöslichen
fusion	fusion
lymphoma	lymphom
immunosuppressive	immunsuppressiva
hepatic	leberfunktionsstörung
webs	stege
inorganic	anorganische
bore	bohrung
hydroxymethyl	hydroxymethyl
/	/
cortical	kortikale
g-protein	g-protein
marketing	genehmigung
orthesis	orthese
substitution	substitution
cardiomyopathy	kardiomyopathie
properties	eigenschaften
months	monaten
bound	gebundenen
dehydrogenase	dehydrogenase
compression	kompression
co-administration	gleichzeitige
mutated	mutierten
clinical	klinischen
wax	wachs
was	betrug
gaseous	gasförmigen
encodes	kodiert
needles	nadeln
catalyst	katalysators
encoded	kodierte
anaesthetic	anästhetika
true	echte
absent	fehlt
maximum	maximalen
cancers	krebserkrankungen
emotional	emotionale
horses	pferde
medication	medikation
aorta	aorta
abstract	zusammenfassung
muscular	muskuläre
evidence	evidenz
xiii	xiii
mole	molprozent
constriction	verengung
circulatory	kreislaufsystems
methyltransferase	methyltransferase
spacers	abstandshalter
porosity	porosität
holding	halteeinrichtung
test	testprobe
stereoisomers	stereoisomere
autonomic	autonomen
lymphadenopathy	lymphadenopathie
transcutaneous	transkutane
interval	intervall
together	zusammen
angiogenesis	angiogenese
bolus	bolus
switches	schalter
adhesions	adhaesionen
supplement	nahrungsergänzungsmittel
hydroxyethylcellulose	hydroxyethylcellulose
dalton	dalton
layers	schichten
varnish	nagellack
zone	zone
formic	ameisensäure
permanently	dauerhaft
rhythm	rhythmus
protective	schützende
orthogonal	orthogonal
respiratory	respiratorischen
prophylactic	prophylaktischen
presented	präsentiert
turns	windungen
monooxygenase	monooxygenase
gum	xanthangummi
discrete	diskreten
liposomes	liposomen
woven	gewebten
sidewall	seitenwand
diarrhoea	durchfall
upper	obere
alfa	alfa
three-dimensional	dreidimensionalen
chemotherapy	chemotherapie
cost	kosten
appear	mindestangaben
scaffold	gerüst
uniform	gleichmäßige
sequential	aufeinanderfolgenden
5-ht	5-ht
paraneoplastic	paraneoplastische
supporting	stützen
genes	genen
cyp3a4	cyp3a4
sieve	sieb
appears	erscheint
change	änderung
precursor	vorstufe
usually	gewöhnlich
reagents	reagenzien
430	430
pancreatitis	pankreatitis
phosphodiesterase	phosphodiesterase
marker	marker
illumination	beleuchtung
rarely	selten
senile	senile
live	lebende
ischemic	ischaemische
symptomatic	symptomatische
car	personenkraftwagens
cap	kappe
cat	cat
incidents	zwischenfaellen
can	kann
cam	nocken
disinfection	desinfektion
lubricant	schmiermittel
trans	trans
stimulating	stimulieren
heart	herzen
spp	spp.
december	dezember
purity	reinheit
capsules	kapseln
serum	serum
infantile	infantile
dialysis	dialyse
means	einrichtungen
nystagmus	nystagmus
distally	distal
product	produkts
influenced	beeinflusst
subdural	subdurale
residues	resten
liposome	liposom
produce	produzieren
0.75	0,75
lifting	hebevorrichtung
epoetin	epoetin
accelerated	beschleunigt
progressively	zunehmend
no.	no.
serving	dienenden
displayed	angezeigt
brain	gehirns
tablets	tabletten
polycystic	polyzystische
nitrogen	stickstoff
coli	coli
still	noch
proteases	proteasen
reacting	umsetzen
vicinity	nachbarschaft
hydrogenation	hydrierung
forms	formen
window	fenster
osteochondrosis	osteochondrose
trna	trna
100,000	100.000
introduce	einzuführen
substituent	substituent
half	hälfte
not	nicht
insulin-like	insulinähnlicher
sweetener	süßungsmittel
halo	halogen
nos	nos
susceptibility	empfindlichkeit
microcrystalline	mikrokristalliner
january	januar
drop	tropfen
domain	domäne
significantly	signifikant
sugars	zuckern
directing	lenken
ec	ec
ex	ex
year	jahr
eu	eu
wavelength	wellenlänge
ribavirin	ribavirin
es	vertragsstaat
shown	gezeigten
polyhydric	mehrwertigen
opened	geöffnet
space	raum
communicating	kommuniziert
pravastatin	pravastatin
increase	erhöhen
receiving	empfang
e.	e.
eluted	eluiert
diagnostic	diagnostischen
oligonucleotide	oligonukleotids
e1	e1
care	pflege
fixed	feststehenden
elastomeric	elastomere
alkyl	alkyl
transition	übergang
510	510
enteropathy	enteropathie
enhancer	verstärker
xi	xi
xa	xa
directly	direkt
comprises	umfasst
ring	ring
size	größe
sheep	schaf
l-carnitine	l-carnitin
sheet	blatt
configured	konfiguriert
nutrition	ernährung
mostly	meist
that	dass
asymmetric	asymmetrische
ritonavir	ritonavir
transverse	querrichtung
gastroenteritis	gastroenteritis
eliminated	eliminiert
than	größer
accordance	übereinstimmung
intensity	intensität
magnesium	magnesium
intrauterine	intrauterine
angioplasty	angioplastie
correction	korrektur
dispersant	dispergiermittel
therefrom	daraus
gingivitis	gingivitis
polynucleotide	polynukleotids
equipment	ausrüstung
objective	fragestellung
gangrene	gangraen
impairment	eingeschränkter
elastically	elastisch
polymorph	polymorphe
centrifugation	zentrifugation
alkoxy	alkoxy
successive	aufeinanderfolgenden
renal	renalen
pharmacist	apotheker
polyvinyl	polyvinylalkohol
aerosol	aerosols
mri	mrt
dispersed	dispergiert
cholerae	cholerae
femur	femur
226	226
testis	hodens
ratio	verhältnisses
proportion	anteil
only	lediglich
enriched	angereichert
alcoholism	alkoholismus
arachidonic	arachidonsäure
anaesthetics	anästhetika
esterification	veresterung
warm-blooded	warmblütigen
symmetrically	symmetrisch
glutathione	glutathion
immobilising	immobilisierung
erythromycin	erythromycin
pituitary	hypophyse
stabilisers	stabilisatoren
irradiation	bestrahlung
physically	physikalisch
hydroxyalkyl	hydroxyalkyl
bioreactor	bioreaktor
anchored	verankert
-n-	-n-
angina	angina
colours	farben
3	3
between	zwischen
-cooh	-cooh
therapies	therapien
notice	bemerken
-nr	-nr
-nh	-nh
article	artikels
hydrate	hydrat
pixels	pixel
hypoglycemia	hypoglykaemie
150	150
khz	khz
amine	amin
circumferentially	umfangsrichtung
amino	amino
tropical	tropische
kinases	kinasen
systems	systemen
avian	aviäres
subjecting	unterziehen
wounds	wunden
language	sprache
cystitis	zystitis
external	externen
suspected	verdacht
glomerulonephritis	glomerulonephritis
developing	entwickeln
these	diesen
polymer	polymer
orientation	orientierung
alcoholic	alkoholischen
inflatable	aufblasbaren
bias	vorspannung
develop	entwickeln
media	medien
halogenated	halogenierten
immobilised	immobilisierten
foam	schaum
swallow	schlucken
severe	schwerer
extensible	dehnbare
charged	geladene
edema	oedem
transmitting	senden
typhus	fleckfieber
ci	ci
valuable	wertvolle
hirudin	hirudin
relevant	relevanten
ribosomal	ribosomale
touch	berühren
speed	geschwindigkeit
death	tod
angiotensin	angiotensin
phlebitis	phlebitis
improvement	besserung
treatment	behandlung
psi	psi
read	lesen
early	frühen
using	verwenden
recipient	empfänger
rear	rückwärtigen
cyclopropyl	cyclopropyl
benefit	nutzen
t	t
output	ausgang
dilution	verdünnung
exposed	ausgesetzt
neutralised	neutralisiert
nucleic	nukleinsäure
duration	dauer
viral	viralen
salicylic	salicylsäure
isobutyl	isobutyl
hepatitis	hepatitis
fractures	frakturen
assembly	baugruppe
sixth	sechsten
equivalent	äquivalent
sedimentation	esr
diet	diät
transported	transportiert
src	src
central	zentralen
enzymatic	enzymatischen
gums	zahnfleisch
antibody	antikörpers
processor	prozessor
4-methylphenyl	4-methylphenyl
heater	heizvorrichtung
disinfectant	desinfektionsmittel
aortic	aortenaneurysma
protease	protease
inclusion	einschluss
cyclophosphamide	cyclophosphamid
electrosurgical	elektrochirurgische
stabilisation	stabilisierung
hyperglycemia	hyperglykämie
your	ihr
intervention	intervention
loc	bsv
area	querschnittsfläche
removing	entfernen
meningococcal	meningokokken
start	beginnen
cats	katzen
low	niedrigen
tautomers	tautomere
delayed	verzoegerte
posterior	posteriore
lymph	befall
embedded	eingebettet
microemulsion	mikroemulsion
appliance	orthodontische
aneurysm	aneurysma
trigeminal	trigeminus
lactobacillus	lactobacillus
moved	bewegt
1200	1200
sheath	hülle
moves	bewegt
hospitals	krankenhäuser
meningitis	meningitis
antenna	antenne
inactivation	inaktivierung
storage	lagerung
terminating	endet
you	ihnen
polar	polare
bacillus	bacillus
condensation	kondensation
3-6	3-6
3-5	3-5
cores	kerne
since	seit
culturing	kultivieren
month	monat
inflating	aufblasen
post-marketing	markteinführung
osteoporosis	osteoporose
-c	-c
-n	-n
-h	-h
hyperthermia	hyperthermie
-s	-s
-r	-r
nodes	lymphknoten
cdna	cdna
mpa	mpa
very	sehr
apoptosis	apoptose
vera	vera
decide	entscheiden
rnase	rnase
candida	candida
generalised	generalisierter
louis	st.
-5	-5
-4	-4
-1	-1
-3	-3
-2	-2
asymptomatic	asymptomatische
promoter	promotor
rectangular	rechteckigen
housed	untergebracht
thickness	dicke
conjunctivitis	konjunktivitis
ichthyosis	ichthyosis
modify	modifizieren
u-shaped	u-förmigen
modular	modulare
selective	selektive
excess	überschuss
multiforme	multiforme
strong	starken
urokinase	urokinase
amount	menge
sealing	abdichten
biodegradable	abbaubare
family	familie
requiring	erfordern
vasopressin	vasopressin
cosmetic	kosmetischen
haemoglobin	hämoglobin
conventional	herkömmlichen
takes	stattfindet
contains	enthält
demyelinating	demyelinisierende
nonsteroidal	nichtsteroidale
fondaparinux	fondaparinux
taken	genommen
injury	verletzung
lowering	senkung
staphylococcus	staphylococcus
diol	diol
lipoprotein	lipoprotein
mounted	montiert
producing	produzierende
puerperium	wochenbett
xylitol	xylitol
spontaneous	spontane
history	vorgeschichte
ions	ionen
radiotherapy	radiotherapie
lacks	fehlt
species	spezies
kaposi	kaposi
baculovirus	baculovirus
polyamides	polyamiden
fr	fr
mononucleosis	mononukleose
derived	abgeleiteten
fe	fe
osteomyelitis	osteomyelitis
horizontal	horizontalen
nephropathy	nephropathie
a	a
morphine	morphin
moraxella	moraxella
enzymes	enzymen
laminate	laminat
deterioration	verschlechterung
dispersing	dispergieren
egg	ei
help	helfen
reservoir	reservoir
urine	urin
soon	sobald
mucosa	schleimhaut
held	gehalten
thermal	thermische
n-butyl	n-butyl
committee	ausschuss
cardiovascular	kardiovaskulären
lateral	lateralen
selenium	selen
cutis	cutis
absence	abwesenheit
disclosed	offenbart
prodrugs	prodrugs
radical	radikalische
deformation	verformung
polyacrylic	polyacrylsäure
food	nahrungsmitteln
aphasia	aphasie
foot	fuß
intranasal	intranasale
stopper	stopfen
fully	vollständig
retinitis	retinitis
stopped	abgebrochen
radial	radiale
ifo	ifo
heavy	lastkraftwagen
jaws	backen
positioned	positioniert
beyond	hinaus
event	ereignis
planus	planus
surrounded	umgeben
safety	sicherheit
inactivated	inaktivierten
7	7
anhydride	anhydrid
asp	asp
inert	inerte
protruding	vorstehende
enantiomers	enantiomere
caspase	caspase
reason	grund
base	base
v.	b.v.
pseudomonas	pseudomonas
ask	fragen
algae	algen
american	american
heartbeat	herzschlag
hodgkin	hodgkin
probability	wahrscheinlichkeit
encoding	codierend
reflected	reflektierten
incubated	inkubiert
warts	warzen
st.	st.
obtainable	erhältlich
fibrillation	vorhofflimmern
tetrahydrofuran	tetrahydrofuran
bowel	darmerkrankung
antitumor	antitumormittel
antibacterial	antibakteriellen
basal	basal
cartridges	patronen
ventricle	ventrikel
insuman	insuman
translation	translation
≤	≤
≥	≥
cysteine	cystein
recovered	gewonnen
ncimb	ncimb
toward	hin
chmp	chmp
phobic	phobische
contraception	empfängnisverhütung
polyoxyethylene	polyoxyethylen
substantial	wesentliche
hemangioma	haemangiom
maleic	maleinsäure
concentration	konzentration
organs	organen
lid	deckels
retracted	zurückgezogenen
cava	cava
swallowing	schlucken
labour	wehen
lip	lippe
naproxen	naproxen
proline	prolin
experienced	erfahrung
350	350
pdgf	pdgf
alpha	alpha
approved	zugelassen
prostatic	prostata-tumoren
achalasia	achalasie
mobile	mobile
clear	klare
intramuscular	intramuskulären
nonspecific	nichtspezifische
velocity	geschwindigkeit
fetal	fetaler
tubes	röhren
dermatological	dermatologischen
caries	karies
completion	abschluss
parameters	parametern
paranoid	paranoide
circle	kreis
hydrolysed	hydrolysiert
biopsy	biopsie
capsule	kapsel
combinations	kombinationen
during	während
transgenic	transgener
transferrin	transferrin
perfume	duftstoff
underlying	zugrunde
recommendations	empfehlungen
x	x
scanning	abtasten
monosaccharide	monosaccharid
culture	kultur
schizophrenia	schizophrenie
close	schließen
precursors	vorläufer
polymorphic	polymorphe
platelet	thrombozytenzahl
conditions	bedingungen
saponin	saponin
statistically	statistisch
web	bahn
spray	spray
clarithromycin	clarithromycin
both	beide
schizoaffective	schizoaffektive
sputum	sputum
sensitive	empfindlich
vault	sd
histamine	histamin
experimental	experimentelle
battery	batterie
lauryl	natriumlaurylsulfat
cross-sectional	querschnittsfläche
stereoisomeric	stereoisomeren
ectopic	ektopische
vessel	gefäßes
meningitidis	meningitidis
described	beschriebenen
maintenance	erhaltungsdosis
collected	gesammelt
slits	schlitzen
ganglion	ganglion
generating	erzeugende
packs	packungen
leukoplakia	leukoplakie
determination	bestimmung
liver	leber
while	auf-
covalently	kovalent
loop	schleife
pack	packung
vectors	vektoren
herein	hierin
hydrolysing	hydrolysieren
full-length	voller
ready	bereit
baseline	ausgangswert
monomeric	monomere
ester	esters
composition	zusammensetzung
used	verwendeten
temporary	vorübergehenden
fatty	fettsäure
optic	optik
003	003
002	002
001	001
000	000
uses	verwendungen
006	006
005	005
004	004
009	009
008	008
nylon	nylon
database	datenbank
myeloma	myelom
striae	striae
cozaar	cozaar
belgium	belgien
adjustable	einstellbare
0.0001	0,0001
0.0005	0,0005
genitourinary	urogenitale
laterally	seitlich
transformation	transformation
...	...
march	märz
lacking	fehlt
branched-chain	verzweigtkettige
sorbitol	sorbit
wings	flügel
diuretics	diuretika
signal	signal
holes	löcher
some	einige
lips	lippen
towards	hin
resin	harzes
mucous	schleimhäute
transversely	quer
delivered	entbunden
exceeding	übersteigt
closely	engmaschig
radioisotope	radioisotop
minimal	minimal
imidazole	imidazol
sympathetic	sympathische
thyroxine	thyroxin
processing	verarbeitung
rue	rue
multivalent	mehrwertige
step	schritt
77	77
ill-defined	unzureichend
working	arbeitsgruppe
hinge	scharnier
replacement	ersatz
therethrough	hindurch
block	block
within	innerhalb
asparagine	asparagin
diametrically	diametral
isoleucine	isoleucin
retinopathy	retinopathie
placing	anordnen
manufacture	herstellung
bursitis	bursitis
russian	russische
tryptophan	tryptophan
injection	injektion
phenylalanine	phenylalanin
mineral	mineralischen
microorganisms	mikroorganismen
skull	sd
yeasts	hefen
transmits	überträgt
psychosis	psychose
n-terminus	n-terminus
similar	ähnlichen
malic	äpfelsäure
tricyclic	tricyclische
adults	erwachsene
interventions	interventionen
metals	metallen
tomography	tomographie
kidney	niere
cotton	baumwolle
nad	nad
amounts	mengen
lansoprazole	lansoprazol
hydrates	hydrate
application	aufbringung
electrical	elektrischen
genome	genoms
pp60	pp60
calculating	berechnen
granuloma	granuloma
structure	struktur
independently	unabhängig
correlated	korreliert
e	e
required	erforderliche
visual	visuellen
novartis	novartis
depth	tiefe
zidovudine	zidovudin
avidin	avidin
requires	erfordert
gr	gr
gp	gp
amphotericin	amphotericin
ge	ge
gd	gd
hypothyroidism	hypothyreose
elution	elution
gm	gm
ammonia	ammoniak
gi	gi
excluded	ausgeschlossen
cellular	zellulären
polymeric	polymeres
nausea	übelkeit
modulator	modulator
stiff	steifen
positions	positionen
button	knopf
voriconazole	voriconazol
pemphigus	pemphigus
zn	zn
intraocular	intraokularen
cell	zelle
evoked	evozierte
volatile	flüchtigen
emulsion	emulsion
vegf	vegf
;	;
radicals	reste
disaccharide	disaccharid
convert	umzuwandeln
products	produkten
polyacrylate	polyacrylat
gene	gens
three-wheeled	dreiraedrigen
austria	österreich
anomalies	anomalien
remains	bleibt
camera	kamera
vehicle	vehikel
stem	stammzellen
started	begonnen
non-human	nicht-menschlichen
trocar	trokar
153	153
control	steuer-
thermally	thermisch
atorvastatin	atorvastatin
cross-section	querschnitts
defective	defekte
arrangement	anordnung
vesicular	vesikuläre
digoxin	digoxin
atpase	retikulum
filament	filament
circular	kreisförmigen
aureus	aureus
rays	strahlen
fatigue	müdigkeit
contraceptives	kontrazeptiva
dilatation	dilatation
least	zumindest
sperm	sperma
localised	lokalisierte
including	einschließend
converting	umwandeln
outer	äußere
temporal	zeitliche
thrombocythemia	thrombozytämie
pixel	pixel
surrounds	umgibt
mesothelioma	mesotheliom
enantiomeric	enantiomeren
021	021
hands	hände
front	vorderen
myocarditis	myokarditis
slide	gleiten
mode	modus
hyperglycaemia	hyperglykämie
shaking	schütteln
proteinuria	proteinurie
globe	augapfels
citric	zitronensäure
aggravated	verschlimmert
measure	maß
separating	abtrennen
hlb	hlb-wert
hla	hla
143	143
pectoris	pectoris
emtricitabine	emtricitabin
cause	verursachen
ecg	ekg
reacts	reagiert
withdrawal	entzugssyndrom
completely	vollständig
20,000	20.000
drowning	ertrinken
corrosion	veraetzung
geometry	geometrie
determining	bestimmen
route	wege
times	dreimal
tél	tél
stainless	rostfreiem
lancet	lanzette
date	datum
alanine	alanin
immunoblastic	immunoblastisches
polyurethanes	polyurethanen
subacute	subakute
insecticidal	insektizide
grow	wachsen
attack	attacke
pulverulent	pulverförmigen
prolapse	prolaps
final	endgültigen
pathogen	pathogen
cys	cys
2-6	2-6
2-4	2-4
exactly	genau
chemicals	chemikalien
manipulation	manipulation
intermediates	zwischenprodukte
synergistic	synergistische
hydroxypropylmethylcellulose	hydroxypropylmethylcellulose
arthroplasty	arthroplastik
epidermal	epidermalen
amide	amid
9.0	9,0
aspiration	aspiration
1-20	1-20
bed	bett
providing	bereitstellens
calcitonin	calcitonin
-och	-och
asn	asn
applicant	antragsteller
recesses	ausnehmungen
tabs	laschen
unchanged	unverändert
thereto	daran
ultrasonic	ultraschallwellen
2.2	2,2
need	bedarf
screw	schraube
daltons	dalton
arm	arm
bus	autobusbenutzer
truck	lieferwagens
detector	detektor
p450	p450
venereal	venerische
cycloalkyl	cycloalkyl
connected	angeschlossen
but	aber
mechanically	mechanisch
oil-in-water	öl-in-wasser-emulsion
delivery	abgabesystem
spleen	milz
	
suture	nahtmaterial
hematopoietic	hämatopoetische
12a	12a
12b	12b
saquinavir	saquinavir
cholecystitis	cholezystitis
fluoro	fluor
polysiloxane	polysiloxan
based	basierend
(	(
rash	hautausschlag
reactive	reaktiven
bases	basen
equivalents	äquivalente
sulfur	schwefel
achieve	erzielen
clopidogrel	clopidogrel
overall	insgesamt
120	120
121	121
122	122
123	123
124	124
125	125
126	126
127	127
128	128
129	129
years	jahre
procedures	eingriffe
processes	prozesse
tobacco	tabak
transposition	transposition
gram	gramm
contain	enthalten
embryonic	embryonale
humans	menschen
endometrium	endometrium
operates	arbeitet
computer	computer
powder	pulvers
operated	betrieben
conductivity	leitfähigkeit
placed	platziert
phospholipase	phospholipase
silicone	silicon
state	zustand
neither	weder
kidneys	nieren
methacrylate	methylmethacrylat
comparable	vergleichbar
triethylamine	triethylamin
rinsed	gespült
lecithin	lecithin
distribution	verteilung
undetermined	umstände
limits	grenzen
hiv-2	hiv-2
eucaryotic	eukaryontischen
antisocial	antisoziale
¹	r¹
strains	stämmen
manifestations	manifestationen
neoplastic	neoplastischen
enterocolitis	enterokolitis
crystalline	kristallinen
addition	addition
aligning	ausrichten
cent	jh.
haemorrhage	subarachnoidalblutung
slowly	langsam
minimise	minimieren
esterase	esterase
isolating	isolieren
oth	son
optionally	optional
controlled	kontrollierten
releasing	freisetzen
arginine	arginin
controller	regler
sensed	erfassten
decreased	erniedrigt
granulomatous	granulomatoese
smoking	rauchen
falciparum	falciparum
novel	neuartige
discontinuation	absetzen
coating	beschichtung
surface	oberfläche
arrhythmias	arrhythmien
examined	untersuchenden
sarcoma	sarkom
conical	konische
orbital	orbita
balloon	ballon
autism	autismus
oligomeric	oligomere
parts	-teile
party	arbeitsgruppe
1-9	1-9
1-8	1-8
http	http
promoters	promotoren
1-3	1-3
1-2	1-2
1-5	1-5
effect	effekt
1-7	1-7
1-6	1-6
colouring	farbmittel
destruction	zerstörung
poultry	geflügel
supernatant	überstand
neuropathy	neuropathie
i	i
well	gut
trials	prüfungen
spherical	sphärische
spastic	spastische
resiliently	elastisch
sources	quellen
long-chain	langkettigen
purified	gereinigter
coordination	koordination
arteriosclerosis	arteriosklerose
intracerebral	intrazerebrale
density	dichte
extends	erstreckt
immunological	immunologischen
fats	fetten
262	262
260	260
immediately	sofort
loss	verlust
necessary	notwendigen
sizes	größen
alternatively	alternativ
sized	bemessen
colourant	farbmittel
therein	darin
glycoprotein	glycoprotein
thymus	thymus
phenomena	phänomene
library	bibliothek
artificial	künstlichen
broad	breiten
overlap	überlappen
cellulase	cellulase
inflammation	entzündungen
nonwoven	vliesbahn
?	?
coated	beschichtet
complication	komplikation
expansion	expansion
variation	variation
acetamide	acetamid
offset	versetzt
compatible	kompatibel
myeloid	myeloide
efavirenz	efavirenz
tongue	zunge
previously	zuvor
lhrh	lhrh
ultrasound	ultraschall
h.	h.
additional	zusätzliche
inner	innere
angiitis	angiitis
mofetil	mycophenolatmofetil
sequelae	folgen
hz	hz
stomatitis	stomatitis
vasculitis	vaskulitis
pe	pe
gait	gang
neutral	neutralen
tapers	verjüngt
gain	gewichtszunahme
hb	hb
ear	ohrs
hg	hg
strabismus	strabismus
cells	zellen
carriage	schlitten
converted	umgewandelt
limit	grenze
piece	stück
display	anzeigeeinheit
tissues	geweben
crosslinking	vernetzung
carboxyl	carboxyl
exogenous	exogenen
crystals	kristalle
tadalafil	tadalafil
proteinase	proteinase
chromosome	chromosom
functions	funktionen
ingredients	inhaltsstoffe
folic	folsäure
parathyroid	nebenschilddruese
acrylic	acryl-
nsaid	nsaid
radially	radial
additionally	zusätzlich
hcv	hcv
8000	8000
phosphorus	phosphor
shunt	shunt
persistent	persistierende
portion	abschnitts
diagnosis	diagnose
indirectly	indirekt
aranesp	aranesp
powdery	pulverförmige
dissolution	auflösung
degradable	abbaubaren
dynamic	dynamischen
powders	pulvern
obstruction	obstruktion
tensile	zugfestigkeit
neoplasia	neoplasie
consists	besteht
auc	auc
penile	penis
segments	segmente
disability	behinderung
contained	enthaltenen
presents	präsentiert
characterised	charakterisiert
neurofibromatosis	neurofibromatose
p2	p2
downstream	stromabwärts
hypertensive	hypertensive
activation	aktivierung
connects	verbindet
affect	beeinflussen
solution	lösung
vector	vektors
cholesterol	cholesterin
enhance	steigern
force	kraft
pleura	pleura
10b	10b
10a	10a
likely	wahrscheinlich
even	sogar
nec	ane
foodstuffs	lebensmitteln
new	neuen
tips	spitzen
particulate	partikuläre
men	männern
disposable	wegwerfbare
met	met
108	108
109	109
102	102
103	103
100	100
101	101
106	106
107	107
104	104
105	105
dry	trockenen
*lsqb*	&#91;
nebuliser	zerstäuber
perinatal	perinatalperiode
guide	führung
transfected	transfiziert
permit	gestatten
suitable	geeigneten
adolescents	jugendlichen
fragrances	parfums
spinocerebellar	spinozerebellare
straight-chain	geradkettiges
tertiary	tertiären
laryngeal	larynx
arms	arme
type	typs
tell	informieren
lungs	lungen
composite	verbundstoff
warm	warmblütigen
biotin	biotin
aligned	ausgerichteten
mycoses	mykosen
moulded	geformten
pivoting	schwenken
room	raumtemperatur
rim	randes
epidermolysis	epidermolysis
give	ergeben
keratitis	keratitis
dosing	dosiervorrichtung
10,000	10.000
foods	lebensmitteln
insemination	insemination
haematological	hämatologische
undergoing	unterziehen
replacing	ersetzen
abdomen	abdomens
passageway	durchgang
third	dritte
manic	manische
mutagenesis	mutagenese
scleroderma	sklerodermie
restenosis	restenose
fungi	pilzen
maintain	aufrechtzuerhalten
sterilisation	sterilisation
operations	operationen
fetus	schaedigung
amplifying	amplifizieren
belgien	belgien
co-operating	zusammenwirkenden
chondroitin	chondroitinsulfat
responsive	anspricht
gastrointestinal	gastrointestinalen
before	bevor
10.0	10,0
pharma	pharma
glycerine	glycerin
personal	hygiene
,	,
better	bessere
weeks	wochen
inhibitor	inhibitors
combination	kombination
fixation	fixierung
weakness	schwäche
drowsiness	benommenheit
polysorbate	polysorbat
modification	modifikation
therapy	therapie
celecoxib	celecoxib
bronchial	bronchiale
ventilation	beatmung
acoustic	akustischen
side	seite
bone	knochens
bond	einfachbindung
interruption	unterbrechung
chlamydial	chlamydien
successively	nacheinander
apolipoprotein	apolipoprotein
aids	aids
extract	extrakt
gradient	gradienten
restricted	beschränkt
particles	partikeln
adhesion	adhäsion
linear	linearen
244	244
240	240
242	242
starts	beginnt
perforated	perforierten
007	007
inbred	inzuchtstamm
cleaning	reinigungs-
features	merkmalen
sterilising	sterilisieren
thereof	hiervon
hook	haken
metabolised	metabolisiert
plurality	mehrzahl
ophthalmological	ophthalmologische
struts	streben
dyskinesia	dyskinesie
admixing	vermischen
symptom	symptom
p53	p53
boarding	auf-
distance	distanz
anxiety	angst
older	älter
preparation	präparation
matter	stoffzusammensetzung
biochemical	biochemische
extracting	extrahieren
modulating	modulierung
membranes	membranen
seed	samen
seen	gesehen
gm-csf	gm-csf
fitting	versorgen
butyl	butyl
resectable	operabel
intravenously	intravenös
worsening	verschlechterung
impurities	verunreinigungen
regular	regelmäßigen
testicular	hoden
tyr	tyr
tautomer	tautomeren
observation	beobachtung
medical	medizinisches
urogenital	urogenitale
dog	hund
points	punkten
principle	prinzip
atresia	atresie
anticancer	antikrebsmittel
fungal	pilzinfektionen
probe	sonde
alcohols	alkoholen
acne	akne
folded	gefalteten
sugar	zucker
above	oberhalb
haemophilus	haemophilus
stop	anschlag
bar	bar
microscopy	mikroskopie
bag	beutels
microscope	mikroskop
discs	scheiben
18	18
fertility	fertilität
testing	testen
zones	zonen
mature	reifen
encephalopathy	enzephalopathie
hydrocarbon	kohlenwasserstoff
subject	subjekt
02	02
00	00
said	besagtem
06	06
07	07
04	04
inappropriate	unangemessene
08	08
connective	bindegewebe
omeprazole	omeprazol
tolerance	toleranz
polyarthritis	polyarthritis
releasably	lösbar
vitamin	vitamin
lotion	lotion
releasable	lösbare
loading	beladen
3-pyridyl	3-pyridyl
agonist	agonist
resistant	resistent
eyeball	augapfels
elastomer	elastomer
against	gegen
cartilage	knorpel
16a	16a
16b	16b
height	höhe
hygiene	hygiene
loaded	beladen
ether	ether
multifocal	multifokale
recognises	erkennt
basis	flächengewicht
neonatorum	neonatorum
three	drei
particulars	angaben
commission	kommission
recognised	erkannt
116	116
interest	interesse
basic	basischen
immunologically	immunologisch
ethers	ethern
efficacy	wirksamkeit
suppress	unterdrücken
bushing	buchse
168	168
164	164
165	165
166	166
160	160
161	161
162	162
exception	ausnahme
remaining	verbleibenden
near	nahe
*lcb*	*lcb*
0.35	0,35
ix	ix
seven	sieben
microparticles	mikropartikel
concomitant	gleichzeitige
backrest	rückenlehne
is	ist
streptococcal	streptokokken
iu	iu
it	it
iv	iv
ii	ii
anastomosis	anastomose
in	in
ia	ia
ic	ic
ib	ib
mouse	maus
id	id
breast-feeding	stillzeit
if	falls
grown	gezüchtet
abscess	abszess
bottles	flaschen
make	machen
sinusitis	sinusitis
mixtures	gemische
vegetable	pflanzliches
kit	kit
pharmacological	pharmakologische
i.	i.
hydroxyethyl	hydroxyethylcellulose
squamous	plattenepithelkarzinom
materials	materialien
claims	patentansprüche
800	800
left	linken
consciousness	bsv
⁷	r⁷
identify	identifizieren
salivary	speicheldruese
human	menschlichem
secure	sichern
calmodulin	kalzium-kalmodulin-abhängige
b-cell	b-zell-lymphom
syncope	synkope
affinity	affinität
spasms	spasmen
drug-induced	arzneimittelinduzierte
lispro	lispro
hypersensitive	überempfindlich
orthodontic	orthodontische
background	hintergrund
shoulder	schulter
performing	durchführen
manual	manuelle
subtilis	subtilis
elderly	älteren
pain	schmerzen
dense	dichten
electromagnetic	elektromagnetischen
normal	normalen
nipple	brustwarze
slurry	aufschlämmung
incidence	inzidenz
meanings	bedeutungen
burn	verbrennung
metastatic	metastasen
bolt	bolzen
selectable	selektierbaren
heparin	heparin
ribs	rippen
influenzae	influenzae
magazine	magazin
vaginal	vaginale
automatically	automatisch
nerve	nervs
formulae	formeln
22a	22a
initial	anfänglichen
influencing	beeinflussung
fraction	fraktion
form	form
polyols	polyolen
spike	dorn
failure	herzversagen
diaper	windel
228	228
blindness	blindheit
225	225
224	224
222	222
221	221
220	220
crosslinked	vernetzten
prevents	verhindert
milligrams	milligramm
attached	befestigte
acetabular	hüftgelenkpfanne
cyclohexyl	cyclohexyl
separated	abgetrennt
neuritis	neuritis
petit	petit
ankylosis	ankylose
covers	abdeckt
gland	speicheldruese
graft	transplantat
marking	markieren
shigella	shigella
polyvalent	mehrwertige
generally	allgemein
oestrogen	östrogen
fixator	fixateur
digital	digitalen
optically	optisch
sling	schlinge
willebrand	willebrand-krankheit
ammonium	ammonium
authorities	behörden
fsh	fsh
daily	täglichen
jacket	mantel
teeth	zähnen
pellets	pellets
customary	üblichen
walking	gehen
mild	milde
skin	haut
primer	primers
milk	milch
retention	retention
di-	di-
disorders	störungen
polyunsaturated	mehrfach
technique	technik
micrometers	mikrometern
0	0
finally	schließlich
yeast	hefe
fibrocystic	fibrozystische
staples	klammern
1996	1996
accidentally	versehentlich
magnet	magnet
mycophenolate	mycophenolatmofetil
round	runde
burkitt	burkitt-tumor
tiredness	müdigkeit
trisomy	trisomie
bacterial	bakteriellen
filler	füllstoff
acidosis	azidose
prolonged-release	retardtabletten
template	matrize
polylactic	polymilchsäure
international	international
filled	gefüllt
pivotally	schwenkbar
implanted	implantierten
cranial	hirnnerven
institute	institute
odour	geruch
corynebacterium	corynebacterium
simultaneous	gleichzeitigen
diagnosed	diagnostiziert
pseudotumor	pseudotumor
cyst	zyste
hbv	hbv
massage	massagegerät
rheumatic	rheumatische
spatially	räumlich
regeneration	regeneration
flexibility	flexibilität
transplant	transplantats
sweating	schwitzen
additive	additiv
cooperates	zusammenwirkt
france	frankreich
connector	verbinder
encode	codieren
tachycardia	tachykardie
aspirin	aspirin
ductus	ductus
acceptable	annehmbaren
antigens	antigenen
rigid	starre
ultraviolet	uv-strahlung
rotational	drehbewegung
indicates	anzeigt
deformed	verformt
half-life	halbwertszeit
growing	züchten
making	schminken
septum	septum
dosage	dosierungsform
claim	anspruchs
reflector	reflektor
agent	agens
sample	probe
14b	14b
14a	14a
redness	rötung
dyspnoea	dyspnoe
chemical	chemischen
hypersensitivity	überempfindlichkeit
pure	reinem
pins	stifte
146	146
144	144
145	145
142	142
mat	matte
140	140
141	141
may	möglicherweise
max	max
fed	zugeführt
148	148
accessory	akzessorische
gelatin	gelatine
designed	ausgestaltet
mah	inhaber
mal	tonisch-klonische
neck	halses
elongation	dehnung
triglyceride	triglycerid
q	q
switch	schalter
talc	talk
african	afrikanische
talk	sprechen
scotoma	skotom
esters	estern
shield	abschirmung
stability	stabilität
pitch	steigung
differs	unterscheidet
sds-page	sds-page
adhesive	kleber
group	gruppe
monitor	monitor
aplastic	aplastische
listing	sequenzprotokoll
main	hauptkörper
cyano	cyano
tonic	tonische
neoplasms	prostata-tumoren
viraferonpeg	viraferonpeg
necrotizing	nekrotisierende
iiia	iiia
markings	markierungen
guidewire	führungsdrahtes
deutschland	deutschland
eyelid	augenlides
fistula	fistel
abnormal	abnormen
living	lebenden
sitagliptin	sitagliptin
dioxide	titandioxid
sensor	sensor
vaginitis	vaginitis
neurotrophic	neurotrophe
after	nachdem
pumping	pumpen
bayer	bayer
vinyl	vinylacetat
lipodystrophy	lipodystrophie
cough	husten
l-lysine	l-lysin
nrrl	nrrl
substrates	substraten
first	erste
polyhydroxyalkanoate	polyhydroxyalkanoat
long	langen
suspended	suspendiert
specificity	spezifität
carry	tragen
mammary	brustdrüse
little	wenig
limited	limited
genotype	genotyp
1a	1a
psychotic	psychotischen
1c	1c
1b	1b
moisture	feuchtigkeit
1h	1h
anus	anus
eyes	augen
continuous	kontinuierliche
adrenergic	adrenerge
ambulatory	ambulante
formaldehyde	formaldehyd
ceramics	keramik
11	11
10	10
13	13
12	12
15	15
14	14
17	17
16	16
19	19
notches	kerben
protected	geschützte
were	waren
1-	1-
nifedipine	nifedipin
20a	20a
winding	wicklung
irbesartan	irbesartan
castor	rizinusöl
potential	potential
interior	innenraum
performance	leistung
modulus	elastizitätsmodul
switching	umstellung
channel	kanal
201	201
200	200
203	203
202	202
205	205
204	204
207	207
206	206
salpingitis	salpingitis
208	208
enter	eintreten
beta	beta
sheets	folien
tract	gallenwege
pair	paar
radioactive	radioaktiven
especially	speziell
napkin	damenbinde
parkinsonism	parkinsonismus
4-methoxyphenyl	4-methoxyphenyl
obstructive	obstruktiver
show	zeigen
cornea	hornhaut
pichia	pichia
accession	zugangsnummer
htlv-iii	htlv-iii
stannous	zinn
threshold	schwellwert
methylcellulose	methylcellulose
aspartic	asparaginsäure
behind	hinter
black	schwarzer
lipids	lipiden
admixture	beimischung
extracellular	extrazellulären
3,4-dichlorophenyl	3,4-dichlorphenyl
get	bekommen
designated	bezeichnung
secondary	sekundären
communicates	kommuniziert
median	mediane
medial	medialen
summary	zusammenfassung
subtype	subtyp
transdermal	transdermales
polynucleotides	polynukleotide
seat	sitz
relative	relativen
seam	naht
seal	dichtung
insoluble	unlösliche
rigidly	starr
label	etikett
metabolites	metaboliten
0.025	0,025
geometric	geometrische
reading	leserahmen
across	hinweg
atrophic	atrophische
tub	wanne
cervical	zervikale
bioactive	bioaktiven
according	gemäß
steroid	steroid
needleless	nadellose
cancer	krebszellen
synovitis	synovitis
50,000	50.000
maintained	aufrechterhalten
stretched	gestreckten
saccharomyces	saccharomyces
tumour	tumors
capable	fähig
attaching	anbringen
402	402
meninges	meningen
oxidising	oxidierenden
bms	bms
overdose	überdosierung
those	diejenigen
hybridised	hybridisiert
epidermis	epidermis
enteritis	enteritis
deformities	deformitaeten
hdl	hdl
endothelial	endothelzellen
characteristics	merkmalen
strain	stamm
pressing	pressen
protein	proteins
movements	bewegungen
different	unterschiedlichen
doctor	arzt
film-forming	filmbildendes
same	selben
adsorption	adsorption
speech	sprache
oil	öls
cncm	cncm
suppurative	eitrige
acetyl	acetyl
band	bandes
hydroxy	hydroxy
vertebra	wirbel
bullosa	bullosa
bottle	flasche
t-pa	t-pa
enteral	enterale
multiplex	multiplex
gated	getriggerte
adrenal	nebenniere
ethyl	ethyl
asthma	asthma
4	4
grip	griffteil
inhibition	inhibition
grid	gitter
mol	mol
defibrillator	defibrillator
vertically	vertikal
identifying	identifizieren
serves	dient
facing	zugewandten
chamber	kammer
either	entweder
neuronal	neuronalen
drainage	drainage
epitope	epitop
alternately	abwechselnd
catalytic	katalytischen
anaemias	anaemien
specified	spezifiziert
images	bildern
spasm	spasmus
excitation	anregung
fluids	fluide
inject	injizieren
expressing	exprimieren
moderate	mäßiger
intravenous	intravenöse
knife	messer
measuring	messen
airways	luftwege
seconds	sekunden
amides	amiden
glycerol	glycerol
manufacturer	hersteller
conducting	leitende
insect	insekten
r1	r1
water-soluble	wasserlöslicher
pockets	taschen
mixed	gemischten
trypsin	trypsin
road	road
erythropoietin	erythropoietin
implantation	implantation
splint	schiene
strip	streifens
pharmaceutical	pharmazeutischen
vials	durchstechflaschen
gravis	gravis
labelling	markieren
tyrosine	tyrosin
granules	körnchen
enough	genug
hydrochloric	salzsäure
orthostatic	orthostatische
swabs	alkoholtupfer
arranged	angeordneten
doxorubicin	doxorubicin
solvents	lösungsmitteln
moles	mol
palate	gaumen
l-arginine	l-arginin
acetate	acetat
orbit	orbita
melatonin	melatonin
film	films
fill	füllen
again	erneut
personnel	personal
field	feldes
nespo	nespo
antimicrobial	antimikrobielle
-6-	-6-
pharmaceutically	pharmazeutisch
deriving	ableiten
important	wichtig
chloro	chlor
remote	entfernten
excretion	ausscheidung
inhibited	gehemmt
incubating	inkubieren
nutrient	nährmedium
ovary	eierstocks
starting	ausgangsmaterial
represent	repräsentieren
forget	vergessen
allergy	allergie
zinc	zink
porcine	schwein
covalent	kovalente
children	kindern
former	filmbildner
autosomal	autosomal
cyclopentyl	cyclopentyl
dohme	dohme
fall	sturz
difference	differenz
capillary	kapillaren
neurological	neurologischen
washing	waschen
progesterone	progesteron
injectable	injizierbaren
gb	gb
glioma	gliom
cerebrovascular	zerebrovaskulaere
zero	null
phage	phagen
further	weiters
residue	aminosäurerest
movement	bewegung
5000	5000
malaria	malaria
cross-linked	vernetztem
component	komponente
ranges	reicht
cylindrical	zylindrische
threads	fäden
capacitor	kondensator
table	tabelle
900	900
ultrafiltration	ultrafiltration
homologous	homolog
toxicity	toxizität
pathological	pathologischen
lymphadenitis	lymphadenitis
cystic	zystische
aluminium	aluminium
pigmented	pigmentiert
suspensions	suspensionen
eye	auges
direction	richtung
two	zweier
comparing	vergleichen
cultivation	kultivierung
aperture	öffnung
0.005	0,005
0.001	0,001
lyophilisate	lyophilisat
cellulitis	zellulitis
polymerisable	polymerisierbaren
controlling	steuern
particular	insbesondere
hour	stunde
↓	↓
↑	↑
sudden	ploetzlicher
proteolytic	proteolytischen
surfactant	tensid
liquid-permeable	flüssigkeitsdurchlässigen
cation	kation
sphere	kugel
minimum	minimalen
numbers	zahlen
sharp	sharp
cerebellar	zerebellare
csf	liquor
acth	acth
plasmodium	plasmodium
advice	rat
blood	bluts
surfactants	tenside
response	antwort
ribozyme	ribozym
randomised	randomisierten
chimeric	chimären
bradycardia	bradykardie
formulations	formulierungen
rounded	abgerundete
neuropathies	neuropathien
hyaluronic	hyaluronsäure
through	hindurch
filters	filtern
lipophilic	lipophile
visceral	viszerale
24	24
25	25
26	26
arteries	arterien
20	20
21	21
22	22
23	23
pcr	pcr
28	28
29	29
late	folgeschaden
detected	detektiert
pad	kissens
antithrombin	antithrombin
good	gute
walls	wände
compound	verbindung
crohn	crohn
histidine	histidin
subcutaneously	subkutan
easily	leicht
2r	2r
pregnant	schwangeren
2a	2a
2b	2b
2c	2c
repeating	wiederholen
2h	2h
clamp	klemme
mental	geistige
energy	energie
hard	harten
engaging	eingreifen
extended	verlängerter
lysis	lyse
granulates	granulate
acting	wirkenden
evaluation	auswerteeinheit
chloroform	chloroform
difficulty	schwierigkeiten
psychosexual	psychosexuelle
members	mitglieder
palmitic	palmitinsäure
benefits	vorteile
polyclonal	polyklonalen
â	â
reinforced	verstärkten
copper	kupfer
nacl	nacl
inhibits	hemmt
600	600
construct	konstrukt
182	182
regulation	regulation
186	186
apnoea	schlafapnoe
185	185
188	188
compartment	abteilung
c-terminus	c-terminus
conduit	rohrleitung
muscles	muskeln
needle	nadel
part	teil
percentage	prozentsatz
cannula	kanüle
incision	einschnitt
cyclic	cyclischen
cyclin	cyclin
intermittent	intermittierende
esterified	verestert
glucose	glucose
treated	behandelte
pre-existing	rueck
dendritic	dendritischen
flared	erweiterten
extracted	extrahiert
listeria	listeria
capillaries	kapillaren
ileus	ileus
most	meisten
humanised	humanisierten
significant	signifikante
services	gesundheitsdienste
extremely	extrem
refrigerator	kühlschrank
kb	kb
kg	kg
kd	kd
dystrophy	dystrophie
mannose	mannose
organism	organismus
particularly	besonders
swelling	schwellungen
relation	beziehung
tgf-β	tgf-β
carefully	sorgfältig
manifold	verteiler
topically	topisch
fine	feine
nervous	nervensystems
distributed	verteilt
-4-	-4-
8	8
cysts	zysten
aspergillosis	aspergillose
carboxylic	carbonsäuren
express	exprimieren
breast	mamma
transitional	uebergangszellkarzinom
remove	entfernen
common	gemeinsamen
sclera	sklera
locating	lokalisierung
pneumatic	pneumatische
proximal	proximalen
opposing	gegenüberliegende
individual	individuellen
microcapsule	mikrokapsel
dimethylamino	dimethylamino
genomic	genomischen
please	bitte
vascular	vaskulären
myopathy	myopathie
hold	halten
encephalitis	enzephalitis
complementary	komplementären
complement	komplement
analogues	analoga
polyolefin	polyolefin
macular	makuladegeneration
folding	falten
generator	generator
nickel	nickel
tapered	verjüngenden
ethoxylated	ethoxylierten
foreign	fremde
supply	stromversorgung
simple	einfachen
newborn	neugeborenen
dietary	nahrungsergänzungsmittel
esophagus	oesophagus
throughout	unternehmen
suppressing	unterdrückung
platinum	platin
rotatable	drehbaren
fused	fusioniert
legionella	legionella
intracellular	intrazellulären
amnesia	amnesie
ireland	ireland
rotatably	drehbar
microspheres	mikrosphären
gas	gases
gap	spalt
amlodipine	amlodipin
porphyria	porphyrie
gag	gag
rupture	ruptur
bile	gallengang
grains	körner
solid	feste
replaced	ersetzt
portugal	portugal
poloxamer	poloxamer
itself	selbst
absorbable	absorbierbare
eczema	ekzem
urethra	harnröhre
ethylene	ethylen
italy	italien
anaesthesia	anästhesie
migraine	migräne
rheumatism	rheumatismus
wherein	worin
textile	textilen
benign	gutartige
subcutaneous	subkutanen
fibrosis	fibrose
development	entwicklung
strips	streifen
osteoarthritis	osteoarthritis
purpose	zweck
injector	injektor
*rpb*	*rpb*
y	y
entry	eintritt
olanzapine	olanzapin
prevention	prävention
bandage	bandage
ldl	ldl
shape	gestalt
alternative	alternative
injuries	verletzungen
alignment	ausrichtung
superficial	oberflaechliche
cut	geschnitten
transcriptase	transkriptase
cup	pfanne
fentanyl	fentanyl
source	quelle
clamping	klemmelement
taxane	taxan
ethylcellulose	ethylcellulose
hallucinations	halluzinationen
vapour	wasserdampf
cognitive	kognitiven
pyridyl	pyridyl
follows	folgt
disks	scheiben
glove	handschuh
flux	fluss
indication	indikation
rheumatoid	rheumatoider
amyotrophic	lateralsklerose
often	oft
metabolic	metabolischen
back	rücken
mirror	spiegel
30a	30a
ecacc	ecacc
scale	skala
contacts	kontakte
pet	pet
decision	entscheidung
integration	integration
per	pro
pressure-sensitive	druckempfindlichen
pen	pen
connecting	verbindenden
scalp	kopfhaut
ped	fußgänger
peg	peg
nose	nase
308	308
evaporating	verdampfen
patient	patient
300	300
301	301
302	302
304	304
candidiasis	candidiasis
306	306
extending	erstreckende
pfizer	pfizer
2-thienyl	2-thienyl
genital	genitalorgane
proportional	proportional
edta	edta
multilayer	mehrschichtige
conduits	leitungen
bores	bohrungen
pharmaceuticals	pharmaceuticals
pneumonitis	pneumonitis
infected	infizierten
forward	vorne
nodular	nodulaere
adjusting	einstellen
benzyl	benzyl
directed	gerichtet
rejection	abstoßung
detachable	abnehmbare
ketone	keton
planes	ebenen
groove	nut
recognition	anerkennung
constant	konstante
lys	lys
flow	strömung
viraferon	viraferon
single	einzigen
triglycerides	triglyceriden
%	%
nigre	niger
b12	b12
faeces	kot
orodispersible	schmelztabletten
intrathoracic	intrathorakalen
endocrine	endokrinen
prepared	hergestellte
lens	linse
fructose	fructose
-phenyl	-phenyl
vehicles	kraftfahrzeugen
2002	2002
2003	2003
2000	2000
2001	2001
2006	2006
2007	2007
2004	2004
2005	2005
uterus	uterus
2008	2008
initiating	einleiten
valves	ventile
magnetically	magnetisch
pneumoniae	pneumoniae
amplifier	verstärker
amplified	amplifizierten
myasthenia	myasthenia
prodrug	prodrug
subtilisin	subtilisin
lilly	lilly
ingredient	inhaltsstoff
random	statistischen
assay	assay
nonmotor	nichtmotorisiertem
molar	molare
entire	gesamte
shock	schock
dimer	dimer
bleeding	blutungen
antigen	antigens
biomaterial	biomaterial
glaxosmithkline	glaxosmithkline
insertion	insertion
grooves	nuten
retracting	zurückziehen
depression	depressionen
extradural	extradurale
pipes	rohre
fat	fett
access	zugang
-2-	-2-
3h	3h
microprocessor	mikroprozessor
3b	3b
3a	3a
exercise	training
body	körpers
exchange	austausch
objects	gegenständen
healing	wundheilung
oxidative	oxidative
tremor	tremor
39	39
38	38
33	33
32	32
31	31
30	30
37	37
36	36
35	35
34	34
tantalum	tantal
3-	3-
composed	zusammengesetzt
peritoneum	peritoneums
formulated	formuliert
trachea	trachea
decrease	abnahme
names	namen
limb	extremitaet
staple	klammer
electrophoresis	elektrophorese
0.1	0.1
administrable	verabreichbare
oils	ölen
oily	ölige
impotence	impotenz
hypopharynx	hypopharynx
insufficiency	insuffizienz
transient	vorübergehende
iia	iia
oleic	ölsäure
iii	iii
account	berücksichtigt
f	f
urethral	harnroehre
closing	schließen
rehabilitation	rehabilitation
e.g.	z.b.
trichoderma	trichoderma
proportions	anteilen
purinergic	purinerge
effectively	effektiv
expandable	expandierbare
taxol	taxol
native	nativem
lysine	lysin
dimethylformamide	dimethylformamid
varied	variiert
holds	hält
regions	regionen
varies	variiert
dilator	dilatator
attachment	anbringung
ketoconazole	ketoconazol
profile	profil
adsorbent	adsorbens
liquid-impermeable	flüssigkeitsundurchlässigen
leukemia	lymphozytenleukämie
collection	collection
leukemic	leukaemische
prostate	prostata
connectable	verbindbar
primers	primer
bind	binden
lines	linien
correspond	entsprechen
synthase	synthase
trochlear	trochlearis
anionic	anionischen
acrylate	acrylat
oral	oralen
symbols	symbole
antipsychotic	antipsychotika
tsh	tsh
located	gelegen
chemotherapeutic	chemotherapeutischen
lh	lh
li	li
erythropoietic	erythropoetische
lu	lu
couplers	kuppler
histological	histologische
junction	verbindungsstelle
greater	größer
mention	erwähnung
cutting	schneiden
liquids	flüssigkeiten
day	tag
mmhg	mmhg
february	februar
l.	l.
₆	r₆
₅	r₅
₄	r₄
₃	r₃
₂	₂
pre-filled	vorgefüllten
haematoma	haematom
l1	l1
tubing	schlauchs
3,000	3000
activate	aktivieren
immunised	immunisiert
programmed	programmiert
treponema	treponema
pivot	schwenkachse
lesion	läsion
sexual	sexuellen
thermoplastic	thermoplastische
actuating	betätigen
barley	gerste
flushing	spülen
red	roten
interaction	interaktion
yarn	garn
facilitate	erleichtern
arterial	arteriellen
plastics	kunststoffen
2,000	2.000
improvements	verbesserungen
mycoplasma	mycoplasma
reached	erreicht
moiety	gruppierung
unspecified	bezeichneter
endoprosthesis	endoprothese
vagina	vagina
intermediate	zwischenprodukt
nitro	nitro
heterocycle	heterocyclus
completed	abgeschlossen
secretion	sekretion
bullous	bulloese
hypercholesterolaemia	hypercholesterinämie
parenterally	parenteral
shampoo	shampoo
ophthalmoplegia	ophthalmoplegie
transducer	wandler
amplitude	amplitude
fermentation	fermentation
unlikely	unwahrscheinlich
have	haben
follicle	follikelstimulierendes
curved	gekrümmte
dementia	demenz
oxidised	oxidierten
acceleration	beschleunigung
minimally	minimal
min	min
322	322
320	320
histoplasmosis	histoplasmose
324	324
serine	serin
unless	sei
starches	stärken
insulating	isolierenden
useful	nützlich
eight	acht
mix25	mix25
stranded	doppelsträngige
disease	krankheit
1,000	1.000
monotherapy	monotherapie
normally	normalerweise
recess	ausnehmung
absorbing	absorbieren
supported	getragen
rotating	rotierenden
kits	kits
controls	steuert
mono-	mono-
inferior	inferior
regularly	regelmäßig
peptide	peptids
polyurethane	polyurethan
starch	stärke
beat	herzschlag
arrhythmia	arrhythmie
beam	strahls
occupant	autobusbenutzer
bead	wulst
areas	bereichen
substrate	substrates
organ	organs
propanol	propanol
excreted	ausgeschieden
pulses	impulsen
cycles	zyklen
looks	aussieht
hydrocarbons	kohlenwasserstoffen
constructing	konstruktion
national	nationalen
cytokine	zytokin
ocular	okuläre
fumaric	fumarsäure
angioedema	angioödem
enhanced	verstärkte
phases	phasen
pattern	muster
boundary	grenze
alveolar	alveoläre
hydrochlorothiazide	hydrochlorothiazide
horizontally	horizontal
choroid	chorioidea
emitted	emittiert
deliver	abzugeben
biosynthesis	biosynthese
taking	einnahmen
prokaryotic	prokaryontischen
equal	gleich
transplantation	transplantation
passing	passieren
placebo	placebo
inflammatory	entzündlichen
invasive	invasiven
vena	vena
mouthpiece	mundstück
copies	kopien
improve	verbessern
anomaly	anomalie
define	definieren
transfusion	transfusion
sulphuric	schwefelsäure
finished	fertigen
cor	cor
deep	tief
angles	rechtwinklig
indinavir	indinavir
biosensor	biosensor
resultant	resultierenden
hypotension	hypotonie
appearance	aussehen
value	wertes
promotes	fördert
backsheet	unterschicht
pneumocystis	pneumocystis
externa	externa
biologically	biologisch
atomiser	zerstäuber
manually	manuell
almost	fast
av	av
claimed	beansprucht
partner	bindungspartner
sequentially	nacheinander
2-pyridyl	2-pyridyl
)	)
administration	verabreichung
coronary	koronaren
fallopian	eileiter
injured	transportmittelunfall
practice	praxis
intravascular	intravaskuläre
ion	metallion
ascorbic	ascorbinsäure
neural	neuronalen
sets	sätze
position	position
muscle	muskels
abutment	anschlag
α-	α-
stores	speichert
glycine	glycin
orthopaedic	orthopädischen
proximity	nachbarschaft
stored	gespeicherten
voltage	spannung
protecting	schutzgruppe
conjugates	konjugate
absorption	absorption
thiazolyl	thiazolyl
guanine	guanin
conjugated	konjugiert
280	280
postpartum	postpartale
tests	tests
otitis	otitis
insert	einsatzes
displaced	verschoben
like	dergleichen
excluding	ausschl
porous	porösem
ozone	ozon
soft	weichen
accessible	zugänglich
hair	haar
topsheet	deckblatt
convex	konvexe
supportive	unterstützende
0.25	0,25
itraconazole	itraconazol
chains	ketten
lipid	lipid
host	wirts
simplex	simplex
although	obwohl
periodically	periodisch
about	etwa
socket	pfanne
introduced	eingeführt
rendered	gemacht
chlamydia	chlamydia
functional	funktionellen
chronic	chronischem
guard	nadelschutz
lactic	milchsäure
female	weiblichen
elastic	elastischer
styrene	styrol
immunotherapy	immuntherapie
700	700
preparations	präparaten
repeated	wiederholten
propylene	propylenglykol
partially	teilweise
j	j
containers	behältern
minutes	minuten
rabbits	kaninchen
pin	stift
exceeded	überschritten
pig	schwein
periods	perioden
our	unserer
antiviral	antiviralen
48	48
49	49
46	46
47	47
44	44
45	45
42	42
43	43
40	40
41	41
4-	4-
special	besondere
u	u
out	heraus
transfection	transfektion
traumatic	traumatischer
bioavailability	bioverfügbarkeit
bundle	bündel
bladder	blase
nozzles	düsen
enlargement	vergrößerung
•	•
contraceptive	kontrazeptiva
peptic	peptisches
lactose	lactose
resolution	auflösung
eliciting	hervorzurufen
pupil	pupille
4b	4b
4a	4a
sweetening	süßungsmittel
two-dimensional	zweidimensionalen
implants	implantaten
sleep	schlaf
enteric	magensaftresistente
appetite	appetit
cytokines	cytokine
poorly	schlecht
klebsiella	klebsiella
palladium	palladium
halogen	halogen
340	340
under	unter
leukocytes	leukozyten
@	@
risk	risikos
amorphous	amorphe
upstream	stromaufwärts
monkeys	affen
induction	induktion
ratiopharm	ratiopharm
enclosing	umschließt
osmotic	osmotischen
direct	direkte
nail	nagel
surrounding	umgebenden
infiltration	infiltration
-alkoxy	-alkoxy
blue	blauer
organisms	organismen
selected	ausgewählten
supplied	zugeführten
supplies	zuführt
jaundice	gelbsucht
injections	injektionszwecke
8a	8a
asthenia	asthenie
ethanol	ethanol
represented	wiedergegeben
shortness	kurzatmigkeit
polycythaemia	polyzythaemie
leaves	blättern
changed	geändert
haemorrhoids	haemorrhoiden
changes	änderungen
hydrophobic	hydrophobes
-co	-co
-cn	-cn
-ch	-ch
-cf	-cf
visible	sichtbaren
would	würde
hospital	krankenhaus
m.	m.
distributing	verteilen
m1	m1
m2	m2
assessment	bewertung
polyether	polyether
pouch	beutels
must	muss
me	me
mg	mg
mm	mm
ml	ml
mn	mn
endogenous	endogenen
streptococcus	streptococcus
sucrose	saccharose
ms	ms
µm	µm
µg	µg
hemoglobin	haemoglobin
preserving	konservierung
schistosoma	schistosoma
end	ende
babinski	babinski
lesions	läsionen
toxin	toxin
adjacent	benachbart
toxic	toxischen
description	beschreibung
arthritis	arthritis
confirmed	bestätigt
lump	knoten
polymerase	polymerase
polycarbonate	polycarbonat
mesh	netz
cement	zement
threonine	threonin
parallel	parallelen
ionic	ionische
undesired	unerwünschter
therebetween	dazwischen
oligomer	oligomer
correlation	korrelation
mastectomy	mastektomie
fillers	füllstoffen
foetal	fetaler
over	hinweg
underside	unterseite
london	london
exhibits	zeigt
406	406
404	404
stearate	magnesiumstearat
400	400
non-small	nichtkleinzelliges
centimetre	zentimeter
408	408
diseases	autoimmunerkrankungen
chromatography	chromatographie
plaster	pflasters
aspergillus	aspergillus
immunogen	immunogen
netherlands	niederlande
prostheses	prothesen
aeruginosa	aeruginosa
dyeing	färben
filling	füllen
each	jedes
naphthyl	naphthyl
constipation	verstopfung
magnets	magneten
combining	kombinieren
large	große
mandrel	dorn
driving	verkehrstüchtigkeit
centreline	mittellinie
tonsil	tonsillen
washed	gewaschen
emphysema	emphysem
clamps	klemmen
acrylamide	acrylamid
resistor	widerstand
perception	wahrnehmung
free	freiem
cirrhosis	zirrhose
proximally	proximal
formation	bildung
biological	biologischen
equine	equines
immunogenic	immunogenen
days	tagen
filter	filters
machining	bearbeitung
cooperating	zusammenwirkende
already	bereits
coding	codierenden
primary	primären
hearing	hörverlust
circumferential	umlaufenden
wild-type	wildtyp
dysfunction	dysfunktion
mercury	quecksilber
immunoassay	immunoassay
0.02	0,02
0.03	0,03
top	oberseite
0.01	0,01
0.04	0,04
0.05	0,05
analgesic	analgetische
analgesia	analgesie
fixedly	fest
toe	zehe
tool	werkzeugs
serve	dienen
wrapped	gewickelt
niemann-pick	niemann-pick-krankheit
tampon	tampon
injected	injiziert
colitis	colitis
brevibacterium	brevibacterium
modulators	modulatoren
plasmid	plasmids
reticuloendotheliosis	retikuloendotheliose
bridge	brücke
rat	ratte
screws	schrauben
regulate	regulieren
relatively	relativ
tartaric	weinsäure
-	-
isolated	isolierten
predominantly	überwiegend
oriented	orientiert
cleft	gaumenspalte
effectiveness	wirksamkeit
rider	motorradfahrer
tibia	tibia
dermal	dermale
complexed	komplexiert
complexes	komplexe
carcinoma	carcinoma
coil	spule
papillomavirus	papillomavirus
cytosine	cytosin
partition	trennwand
metal	metalls
dystonia	dystonie
contacted	kontaktiert
labels	markierungen
solutions	lösungen
carotid	carotis
analogue	analogon
availability	verfügbarkeit
och	och
rinsing	spülen
mixture	gemischs
fluid	fluid
tuberculosis	tuberculosis
despite	trotz
report	berichten
beads	perlen
peroxide	peroxid
twice	zweimal
automatic	automatische
electrodes	elektroden
homopolymer	homopolymer
nut	mutter
non-steroidal	nichtsteroidale
valsartan	valsartan
detection	detektion
depressive	depressive
capacity	kapazität
feline	felines
finger	fingers
368	368
360	360
adding	zugeben
oxidation	oxidation
weak	schwach
however	allerdings
toothbrush	zahnbürste
larynx	kehlkopfes
oxidase	oxidase
lipase	lipase
absorbent	absorbierender
protect	schützen
chlorhexidine	chlorhexidin
extracts	extrakten
ventricular	ventrikulären
faces	zugewandt
operating	betreiben
lenses	linsen
excipients	exzipienten
viruses	viren
clip	clip
been	worden
belongs	gehört
expected	erwartet
protrusions	vorsprüngen
lactis	lactis
drugs	drogen
phosphatidylcholine	phosphatidylcholin
uncommon	gelegentlich
phosphatidylinositol	phosphatidylinositol
microns	mikron
antiretroviral	antiretroviralen
n	n
engageable	bringbar
leprosy	lepra
procedure	eingriffs
purifying	reinigen
broth	kulturbrühe
pathology	pathologie
antidepressants	antidepressiva
containing	enthaltenden
wound	wunde
intersecting	schneidet
complex	komplex
water-miscible	mischbaren
peaks	spitzen
rotor	rotors
polymerisation	polymerisation
cyclo	cyclo
cycle	zyklus
mother	mutter
nanoemulsion	nanoemulsion
transporting	transportieren
dopamine	dopamin
histiocytosis	histiozytose
modulate	modulieren
functionally	funktionell
monitored	überwacht
stent	stent
temporomandibular	temporomandibulargelenks
5a	5a
5b	5b
bands	bänder
chitin	chitin
sanitary	damenbinde
burns	verbrennungen
advanced	fortgeschrittenen
melting	schmelzen
59	59
58	58
55	55
54	54
57	57
56	56
51	51
50	50
53	53
52	52
5-	5-
flaps	klappen
diluent	verdünner
sponge	schwamm
precautions	vorsichtsmaßnahmen
specific	spezifischen
cns	zns
420	420
dissociative	dissoziative
cord	nabelschnur
core	kern
deleted	deletiert
corn	mais
prefilled	vorgefüllte
hsv	hsv
menopause	menopause
plug	stopfen
benzoic	benzoesäure
ensure	sicherzustellen
ptfe	ptfe
presence	anwesenheit
obtaining	erhalt
ppm	ppm
bath	bad
adjuvants	hilfsstoffe
finely	fein
unspec	unspez
anorexia	anorexie
vaccination	impfung
why	warum
halide	halogenid
humalog	humalog
metabolism	metabolismus
synthesis	synthese
head	kopf
medium	medium
chorionic	choriongonadotropin
differences	unterschiede
phenyl	phenyl
wireless	drahtlose
heat	wärme
illuminating	beleuchtung
solar	sonnenlicht
sustained	verzögerter
removed	entfernt
docetaxel	docetaxel
rhinitis	rhinitis
portions	abschnitten
vivo	vivo
phosphate	phosphat
adenosine	adenosin
latch	verriegelung
forearm	unterarms
creatinine	kreatinin
check	überprüfen
tris	tris
constructed	konstruiert
nh	nh
nk	nk
nl	nl
nm	nm
no	no
na	na
tip	spitze
ng	ng
trudexa	trudexa
tin	zinn
implant	implantats
isomers	isomere
incontinence	inkontinenz
il-4	il-4
preceding	voranstehenden
uniformly	gleichmäßig
il-1	il-1
il-2	il-2
discharge	ausfluss
thorax	thorax
voltage-gated	spannungsabhaengiger
longer	längere
serious	schwerwiegenden
nuclei	kerne
varying	variieren
rod	stabes
leads	leitungen
ventilator	ventilator
extremities	extremitäten
displaying	anzeigen
row	reihe
passage	durchtritt
environment	umgebung
charge	ladung
promoting	förderung
ulna	ulna
methyl	methyl
advantage	vorteil
frequencies	frequenzen
disinfecting	desinfizieren
cooh	cooh
excipient	excipienten
level	pegel
filgrastim	filgrastim
lever	hebel
accumulation	anreicherung
epar	epar
pore	porengröße
aliphatic	aliphatischen
dried	getrockneten
port	auslaßöffnung
colic	kolik
recombinantly	rekombinant
remain	bleiben
axial	axialen
520	520
phosphatase	phosphatase
retroviral	retrovirale
alkaline	alkalische
ulceration	ulzeration
water	wassers
groups	-gruppen
supplying	zuführen
healthy	gesunden
hexal	hexal
pivotable	verschwenkbar
resonance	resonanz
inducing	induzierung
modifying	modifizieren
receptors	rezeptoren
crisis	krise
scan	scan
herpes	herpes
memory	speicher
conductor	leiter
immunoglobulins	immunglobuline
employed	eingesetzte
cases	fälle
collision	sonstigem
reflux	reflux
modified	modifizierten
isoimmunisation	isoimmunisierung
mortality	mortalität
polymerizable	polymerisierbaren
isomer	isomer
iodine	jod
nursing	krankenpflege
figure	figur
auxiliaries	hilfs-
stroke	schlaganfall
performed	durchgeführt
counting	zählen
hydrogen	wasserstoff
hydrogel	hydrogel
lipoproteins	lipoproteine
thrombophlebitis	thrombophlebitis
requirements	anforderungen
secured	gesichert
superabsorbent	superabsorbierende
1	1
salts	salzen
fourth	vierte
plus	plus
83	83
methoxy	methoxy
pyridine	pyridin
liquid	flüssigem
joint	gelenk
compressing	pressen
branched	verzweigte
representation	darstellung
benzamide	benzamid
acts	einwirkt
constituents	bestandteilen
mainly	hauptsächlich
-oh	-oh
paracetamol	paracetamol
blocked	blockiert
gtp	gtp
platform	plattform
rapamycin	rapamycin
pharynx	pharynx
ferm	ferm
-o-	-o-
acetone	aceton
name	name
paclitaxel	paclitaxel
water-in-oil	wasser-in-öl-emulsion
tert	tert
individually	einzeln
hydroxide	kaliumhydroxid
factors	faktoren
plasmids	plasmide
hemorrhagic	haemorrhagische
processed	verarbeitet
catheterisation	katheterisierung
bicarbonate	natriumbicarbonat
pathogenic	pathogenen
isotope	isotop
antihistamines	antihistaminika
curable	härtbare
turn	wiederum
place	anstelle
swine	schwein
lactation	laktation
crystallisation	kristallisation
childhood	kindheit
1000	1000
origin	herkunft
dimethyl	dimethylsulfoxid
bordetella	bordetella
array	array
given	gegebenen
fibrinogen	fibrinogen
carbonate	carbonat
plastic	kunststoff
stimulation	stimulation
cooling	kühlen
white	weiß
amines	aminen
hub	nabe
released	freigesetzt
prosthesis	prothese
pathogens	pathogene
copy	kopie
holder	halter
population	population
wide	breiten
require	erfordern
oligonucleotides	oligonukleotiden
r	r
dextrose	dextrose
proteins	proteinen
poisoning	vergiftung
and	und
any	beliebigen
conversion	umwandlung
transcription	transkription
heterologous	heterologes
macrogol	macrogol
contusion	prellung
sure	sicher
multiple	multiplen
falls	fällt
escherichia	escherichia
probes	sonden
latex	latex
tendon	sehne
considered	erwägung
later	später
pores	poren
vulgaris	vulgaris
peptides	peptiden
cortex	nebennierenrinde
applicator	applikator
slope	steigung
permeable	durchlässig
spaced	beabstandete
spacer	spacer
supraventricular	supraventrikuläre
cyclosporin	cyclosporin
homology	homologie
protrusion	vorsprung
2-hydroxyethyl	2-hydroxyethyl
contraction	kontraktion
centrally	mittig
tinnitus	tinnitus
dye	farbstoff
closure	verschlusses
water-absorbent	wasserabsorbierenden
nodosa	nodosa
republika	republika
malformations	missbildungen
enzymatically	enzymatisch
surfaces	oberflächen
detect	detektieren
inhibitory	hemmende
subsequent	nachfolgende
review	review
inhibitors	inhibitoren
outside	außenseite
dextran	dextran
arthropathy	arthropathie
controllable	steuerbar
27	27
coma	koma
pens	pens
comb	comb
reaction	reaktionsprodukt
region	region
sodium	natrium
railway	eisenbahnfahrzeug
filtering	filtern
psychomotor	psychomotorische
period	periode
poly	poly
sampling	abtasten
60	60
61	61
pole	pol
63	63
64	64
65	65
66	66
67	67
68	68
69	69
polydimethylsiloxane	polydimethylsiloxan
immunodeficiency	immunodeficiency
hypertrophic	hypertrophische
deposited	hinterlegt
502	502
500	500
6a	6a
6b	6b
pioglitazone	pioglitazon
isomerase	isomerase
ophthalmic	ophthalmischen
hernia	hernie
case	falle
shaft	welle
sildenafil	sildenafil
premature	vorzeitiger
refractory	refraktaer
stabilising	stabilisierende
coupled	gekuppelt
coupler	kuppler
granted	europäische
locking	verriegelungselement
physical	physikalischen
events	ereignissen
week	woche
biocompatible	biokompatible
driver	fahrer
driven	angetrieben
persons	personen
monocytes	monozyten
conductors	leiter
changing	ändern
antibodies	antikörpern
boehringer	boehringer
inhalation	inhalation
without	ohne
eesti	eesti
components	komponenten
model	modells
bodies	wirbelkörper
when	wann
guided	geführt
c-terminal	c-terminale
differentiation	differenzierung
behavioural	verhaltensstoerungen
electrolyte	elektrolyt
seems	scheint
except	ausnahme
emulsifiers	emulgatoren
association	assoziation
samples	proben
kingdom	königreich
electrolytes	elektrolyte
predetermined	vorbestimmte
coaxial	koaxial
4-hydroxyphenyl	4-hydroxyphenyl
correcting	korrektur
nr	nr
bonding	kleben
acute	akuten
particle	teilchendurchmesser
aqueous	wässrige
2s	2s
adult	erwachsene
reduced	reduziertem
neuralgia	neuralgie
ibuprofen	ibuprofen
developmental	entwicklungsbedingte
o-	o-
colloidal	kolloidale
gelling	geliermittel
legal	legal
provides	bereitstellt
transurethral	transurethrale
il-6	il-6
dicarboxylic	dicarbonsäure
water-absorbing	wasserabsorbierende
ovaries	ovarien
nails	nägel
authorisation	erteilen
keratin	keratinischer
_	_
on	on
oh	oh
enbrel	enbrel
ketoprofen	ketoprofen
paralysis	paralyse
discussed	diskutiert
mutually	gegenseitig
neurodegenerative	neurodegenerativen
concentrations	konzentrationen
or	oder
proto-oncogene	proto-onkogen-proteine
haemangioma	haemangiom
hypothermia	hypothermie
instruments	instrumenten
pick-up	lieferwagens
spinal	spinale
determine	bestimmen
syringe	spritze
there	gab
disposed	angeordnetes
cultured	kultivierten
dispersion	dispersion
dnase	dnase
detectable	nachweisbaren
cultures	zellkulturen
piroxicam	piroxicam
750	750
irradiating	bestrahlen
promote	fördern
n-	n-
applying	aufbringen
complexing	komplexbildner
autoimmune	autoimmunerkrankung
mycobacterium	mycobacterium
taste	geschmack
measurement	messung
cbs	cbs
lichen	lichen
corresponding	korrespondierenden
4.5	4.5
4.4	4.4
-one	-on
4.0	4,0
4.3	4.3
4.2	4.2
bilirubin	bilirubin
t-butyl	t-butyl
4.8	4.8
igg	igg
igf	igf
ige	ige
5	5
iga	iga
igm	igm
immunity	immunität
deviation	abweichung
separate	separate
includes	einschließt
tetracycline	tetracyclin
nucleus	nucleus
recognise	erkennen
included	eingeschlossenen
cytotoxicity	zytotoxizität
clinically	klinisch
bilateral	bilaterale
curve	kurve
citrate	citrat
all	sämtliche
alk	alk
embolism	embolie
keratosis	keratose
ala	ala
surgical	chirurgisches
systemic	systemischen
alt	alt
alu	alu
synthetic	synthetischer
lining	auskleidung
subjected	unterworfen
participants	teilnehmern
prostaglandin	prostaglandin
biliary	gallenwege
assist	unterstützen
activities	aktivitäten
fax	fax
urea	harnstoff
far	weit
induce	induzieren
fan	ventilator
fab	fab
α	α
salmonella	salmonella
γ	γ
δ	δ
treating	behandeln
intervertebral	zwischenwirbelimplantat
list	liste
prolonged	prol
ingelheim	ingelheim
programme	programm
rats	ratten
ten	zehn
rate	rate
oligopeptide	oligopeptid
what	wofür
sum	summe
ovarian	ovarien
crush	quetschverletzung
version	version
condensed	kondensierte
toes	zehen
behaviour	verhaltens
combating	bekämpfung
compressed	komprimierten
directions	richtungen
observing	beobachten
allows	erlaubt
stiffness	steifigkeit
elongated	langgestreckten
cataract	katarakt
haemophilia	hämophilie
vertebral	wirbelkörper
vertebrae	wirbel
coatings	beschichtungen
−	−
research	forschung
intcran	intkran
nontraffic	verkehrs
grafts	transplantate
necrotising	nekrotisierende
flat	flachen
flap	klappe
immersion	eintauchen
antibiotics	antibiotika
pectin	pektin
stethoscope	stethoskop
stick	stiftes
known	bekannten
waxes	wachse
v	v
non-woven	gewebten
osteosarcoma	osteosarkom
joints	gelenken
acetic	essigsäure
sunscreen	sonnenschutzmittel
5.0	5,0
5.1	5.1
5.2	5.2
5.3	5.3
5.5	5,5
cleansing	reinigungszusammensetzung
chorea	chorea
activator	aktivator
parenteral	parenteralen
immobilisation	immobilisierung
fungus	pilz
dissolving	auflösen
short	kurzen
ards	ards
september	september
developed	entwickelten
refractive	brechungsindex
anti-inflammatory	entzündungshemmenden
disabled	behinderte
concentric	konzentrisch
film-coated	filmtablette
susceptible	empfindlich
inward	einwärts
mattress	matratze
interleukin-2	interleukin-2
interleukin-4	interleukin-4
return	rueck
alighting	aussteigen
framework	gerüst
sulphate	sulfat
instructions	anweisungen
zoster	zoster
oppositely	entgegengesetzt
maltose	maltose
amphiphilic	amphiphilen
accommodated	untergebracht
nicotine	nikotin
weight	gewicht
hyperbilirubinemia	hyperbilirubinämie
alcohol	alkohol
p	p
induces	induziert
lyophilised	lyophilisierten
health	gesundheit
induced	induzierten
acetonitrile	acetonitril
penicillium	penicillium
solvent	lösungsmittels
alleviating	linderung
differ	unterscheiden
1-4	1-4
alzheimer	alzheimer
dexamethasone	dexamethason
blister	blister
galactose	galactose
antigenic	antigenes
thread	fadens
93	93
propellant	treibmittel
stretchable	dehnbaren
circuit	schaltung
zyprexa	zyprexa
feed	futter
feel	fühlen
operatively	operativ
aseptic	aseptische
feet	füße
enlarged	vergrößerten
defects	defekte
blank	rohling
"	"
temperature	temperatur
180	180
keratinous	keratinischer
passed	geleitet
racemic	racemischen
positionable	positionierbar
syrup	sirup
store	aufzubewahren
headache	kopfschmerzen
184	184
pump	pumpe
pramipexole	pramipexol
retinal	retinale
serotonin	serotonin
alumina	aluminiumoxid
optical	optischen
neuropathic	neuropathische
vial	durchstechflasche
double	doppelte
teva	teva
cuff	manschette
risks	risiken
dispenser	spender
7b	7b
7a	7a
globulin	globulin
electrochemical	elektrochemische
fetalis	fetalis
febrile	febrile
bacteria	bakterien
finding	befund
stenosis	stenose
added	hinzugefügt
electric	elektromotor
warnings	warnhinweise
7-	7-
measures	misst
react	reagieren
76	76
75	75
74	74
73	73
72	72
71	71
70	70
measured	gemessene
79	79
78	78
polyethylene	polyethylen
grams	gramm
corpus	corpus
tacrolimus	tacrolimus
dissolved	aufgelöst
notch	kerbe
dilation	dilatation
piezoelectric	piezoelektrischen
securing	sichern
congestive	kongestive
windings	windungen
hip	huefte
his	his
oligosaccharides	oligosaccharide
hiv	hiv
cd4	cd4
b	b
5,000	5.000
dose	dosis
ampoule	ampulle
activity	aktivität
dizziness	schwindel
vulva	vulva
achieved	erzielt
seborrhoeic	seborrhoische
pvc	pvc
arc	bogen
injecting	injizieren
are	sind
arg	arg
2.3	2,3
chambers	kammern
2.0	2,0
2.6	2,6
2.5	2,5
2.4	2,4
thrombocytopenic	thrombozytopenische
thrombocytopenia	thrombozytopenie
annexin	annexin
axially	axial
user	benutzers
various	verschiedener
consecutive	aufeinanderfolgende
recently	kurzem
creatine	kreatinkinase
initially	anfänglich
bronchus	bronchien
sole	einzige
ulcerative	ulcerosa
nonionic	nichtionischen
hiv-1	hiv-1
c	c
enkephalin	enkephalin
rollers	rollen
pharmacokinetics	pharmakokinetik
distress	distress
reasons	gründen
sepsis	sepsis
regulated	reguliert
fibres	fasern
slots	schlitze
pp	pp
pt	pt
due	aufgrund
reduction	reduktion
pa	pa
pg	pg
pd	pd
make-up	schminken
ph	ph
po	po
cpmp	cpmp
transferring	überführen
plants	pflanzen
p1	p1
evaluated	ausgewertet
p.	p.
identical	identischen
gel	gels
gasket	dichtung
neurons	neuronen
rib	rippe
immunosuppression	immunsuppression
stimulates	stimuliert
lengths	längen
anti-cancer	antikrebsmittel
stimulated	stimuliert
deletion	deletion
9	9
higher	höheren
literature	literatur
cartridge	patrone
amprenavir	amprenavir
flows	strömt
domains	domänen
moving	bewegen
anhydrous	wasserfreien
lower	niedere
analysis	analyse
edge	kante
machinery	maschinen
pollen	pollen
intervals	intervallen
β	β
questions	fragen
phospholipid	phospholipid
tablet	tablette
exclusively	ausschließlich
anaphylactic	anaphylaktischer
synthesising	synthetisieren
valine	valin
integer	ganze
toluene	toluol
phosphatidyl	phosphatidylcholin
modifications	modifikationen
rotate	drehen
shaped	geformter
polymers	polymeren
separately	separat
unstable	instabile
essential	essentiellen
3.5	3,5
diclofenac	diclofenac
3.0	3,0
gradually	allmählich
waveform	wellenform
fragments	fragmenten
perpendicular	senkrecht
vaccine	impfstoffs
fibula	fibula
4-pyridyl	4-pyridyl
glaucoma	glaukom
impermeable	undurchlässig
leukaemia	leukaemie
range	bereich
gamma	gamma
benzene	benzol
microorganism	mikroorganismus
deafness	taubheit
elasticity	elastizität
gaucher	gaucher-krankheit
rows	reihen
question	frage
fast	schnellen
capacitance	kapazität
albumin	albumin
sections	abschnitte
potassium	kalium
criteria	kriterien
chromosomal	chromosomale
cloth	tuch
monomers	monomere
repeatedly	wiederholt
delta	delta
upright	aufrecht
mediastinal	mediastinums
consist	bestehen
characteristic	charakteristische
growth	wachstums
pegasys	pegasys
111	111
z	z
strands	stränge
called	genannt
x-ray	roentgenaufnahme
associated	assoziierten
winthrop	winthrop
phages	phagen
reservoirs	reservoirs
leucine	leucin
problems	probleme
generated	erzeugten
allowing	gestattet
puncture	punktion
semi-permeable	semipermeable
polyamide	polyamid
fluorescence	fluoreszenz
accidental	versehentliche
amyloidosis	amyloidose
once	einmal
hooks	haken
resistance	resistenz
010	010
011	011
012	012
013	013
015	015
016	016
017	017
tumours	tumore
adjustment	einstelleinrichtung
endocarditis	endokarditis
rigidity	steifigkeit
monomer	monomers
disposal	entsorgung
stably	stabil
stable	stabilen
include	einschließen
vinylpyrrolidone	vinylpyrrolidon
mutation	mutation
adenoviral	adenoviralen
breathing	atmen
refsum	heriditäre
fluoxetine	fluoxetin
engineered	gentechnisch
electron	elektronen
artery	arterie
disintegrant	sprengmittel
alveolitis	alveolitis
polyol	polyol
moulding	formteil
concluded	schluss
smaller	kleineren
gripping	greifen
malignant	malignen
folds	falten
ramipril	ramipril
sensation	gefühl
gmbh	gmbh
acid	säure
somatostatin	somatostatin
degree	grades
bromo	brom
desired	gewünschten
separation	trennung
perforation	perforation
cyclist	fahrrades
larger	größeren
leaving	abgangsgruppe
duct	gallengang
respirator	beatmungsgerät
apo	apo
motor	motor
chromosomes	chromosomen
use	verwendung
from	ausgehend
&	&amp;
germ	keimzellen
few	wenige
examination	untersuchung
enantiomer	enantiomer
scleral	sklera
antioxidants	antioxidantien
polyneuropathy	polyneuropathie
psoriasis	psoriasis
condom	kondom
inclined	geneigt
vesicle	vesikel
infection	infektion
cooperate	zusammenzuwirken
rabbit	kaninchen
penis	penis
thuringiensis	thuringiensis
detects	detektiert
women	frauen
stabilized	stabilisierte
0.9	0,9
0.8	0,8
calculation	berechnung
0.3	0,3
0.2	0,2
0.5	0,5
0.4	0,4
0.7	0,7
0.6	0,6
copolymer	copolymer
tab	lasche
united	vereinigtes
syndrome	syndroms
six	sechs
occur	auftreten
prognosis	prognose
cholera	cholera
instead	anstelle
sio	sio
*lpb*	*lpb*
tuberculous	tuberkuloese
tension	spannung
maternal	mutter
abuse	missbrauch
wrist	handgelenkes
alfa-2b	alfa-2b
light	lichts
interrupted	unterbrochen
manganese	mangan
nasopharynx	nasopharynx
saturated	gesättigte
granulate	granulats
133	133
132	132
131	131
130	130
137	137
136	136
135	135
134	134
138	138
novolet	novolet
portable	tragbaren
superior	superior
longitudinal	longitudinalen
inlet	einlass
transferase	transferase
permanent	dauerhaften
biomedical	biomedizinische
covered	abgedeckt
receptacles	aufnahmen
defining	definieren
13b	13b
13a	13a
succinic	bernsteinsäure
material	materials
arcuate	bogenförmigen
impaired	eingeschränkter
articles	gegenstände
transmitter	sender
progressive	progressive
cosmetically	kosmetisch
transmitted	übertragene
receptor	rezeptors
tray	schale
novomix	novomix
micrograms	mikrogramm
related	verwandte
88	88
89	89
82	82
relates	betrifft
80	80
81	81
86	86
87	87
84	84
85	85
semen	sperma
cerebral	zerebraler
t-cells	t-zellen
impart	verleihen
supports	stützen
integrated	integrierte
angiography	angiographie
proviso	maßgabe
8b	8b
maintains	beibehält
affective	affektive
belgique	belgique
usual	übliche
compositions	zusammensetzungen
eluting	elution
repairing	reparatur
pancreatic	pankreas
organic	organischen
chitosan	chitosan
g	g
removal	entfernung
ltd	ltd
agrobacterium	agrobacterium
hydroxyapatite	hydroxyapatit
embryo	embryo
itching	juckreiz
unknown	unbekannter
antiinflammatory	entzündungshemmende
their	ihre
1500	1500
non-toxic	nichttoxischen
plexus	plexus
hydroxypropylcellulose	hydroxypropylcellulose
shell	schale
x-rays	röntgenstrahlen
conically	konisch
leishmaniasis	leishmaniase
shelf	haltbarkeit
slider	schieber
reflecting	reflektierende
july	juli
314	314
congenital	kongenitale
isolation	isolation
infectious	infektiösen
limiting	begrenzung
purpura	purpura
patients	patientinnen
elongate	länglichen
1.4	1,4
1.5	1,5
1.6	1,6
1.7	1,7
1.0	1,0
1.1	1,1
1.2	1,2
1.3	1,3
linker	linker
1.8	1,8
hybridise	hybridisieren
purification	reinigung
linked	verknüpft
angle	winkel
allergies	allergien
agency	agentur
il-12	il-12
which	welchen
=	=
medicaments	medikamenten
combat	bekämpfen
centre	zentrum
harmful	schädlichen
digestive	verdauungssystems
nucleotide	nukleotid
class	klasse
polyester	polyester
atypical	atypische
meningeal	meningen
spindle	spindel
highest	höchsten
neurogenic	neurogene
septicaemia	septikaemie
-or	-or
local	lokalen
diagnosing	diagnostizieren
malaise	unwohlsein
pasteurella	pasteurella
kaletra	kaletra
dyspepsia	dyspepsie
quaternary	quaternäre
cleavage	spaltung
view	ansicht
europe	europe
inventive	erfindungsgemässen
statistical	statistischen
acquired	erworbene
cationic	kationisches
module	modul
p24	024
p21	p21
030	030
bacteriophage	bakteriophagen
closes	schließt
alcaligenes	alcaligenes
projecting	vorstehende
identification	identifikation
closed	geschlossenen
wetting	netzmittel
thalamus	thalami
ability	fähigkeit
opening	öffnung
neonatal	neonatale
april	april
wall	wand
antioxidant	antioxidans
packaging	behältnissen
sequences	sequenzen
respect	bezug
pulmonary	pulmonalen
rosiglitazone	rosiglitazon
withdrawn	zurückgezogen
electrocardiogram	elektrokardiogramm
i.e.	d.h.
cavities	hohlräume
cross-linking	vernetzen
monoclonal	monoklonalen
determinant	determinante
general	allgemeinen
sufficient	ausreichen
confers	verleiht
improved	verbesserte
coxa	coxa
present	anwesend
reverse	reverse
eyelashes	wimpern
herpesvirus	herpesvirus
wild	wildtyp
medicinal	tierarzneimittel
layer	schicht
mutant	mutante
thus	somit
epitopes	epitope
-butyl	-butyl
cerebrospinal	liquor
ribosome	ribosomen-untereinheiten
radiation	strahlung
cross	querschnitt
member	glied
adverse	unerwünschten
largest	größten
units	einheiten
osteoarthrosis	osteoarthrosis
solubility	löslichkeit
pedal	fahrrad
collar	kragen
lipases	lipasen
resorbable	resorbierbare
sensing	abtasten
bending	biegen
excessive	uebermaessige
gastritis	gastritis
obtain	erhalt
fibrin	fibrin
sarcoidosis	sarkoidose
-alkyl	-alkyl
duodenal	duodeni
rapid	schnelle
point	punkt
nanoparticles	nanopartikel
lymphocytes	lymphozyten
knob	knopf
facial	facialis
press	drücken
variants	varianten
simvastatin	simvastatin
betaine	betain
corners	ecken
exceed	überschreiten
because	weil
sequence	sequenz
kda	kda
115	115
114	114
117	117
phosphoric	phosphorsäure
hypoglossal	hypoglossus
110	110
113	113
112	112
119	119
118	118
antineoplastic	antineoplastische
lead	blei
markers	tumormarker
detergent	detergens
floss	zahnseide
g-csf	g-csf
pyrrolidone	vinylpyrrolidon
11a	11a
reductase	reductase
11b	11b
analysed	analysiert
paediatric	pädiatrischen
fluorescent	fluoreszierende
paste	paste
atherosclerosis	atherosklerose
rare	seltenen
carried	getragen
extension	verlängerung
column	säule
dependence	drogenabhaengigkeit
carries	trägt
carrier	trägerstoff
additives	zusatzstoffen
own	eigenen
brush	bürste
amylase	amylase
maize	mais
van	lieferwagen
val	val
pruritus	pruritus
transfer	transfer
*	*
spiral	spirale
powdered	pulverförmige
macrophage	makrophagen
belonging	gehören
triggered	ausgelöst
corneal	hornhaut
volume	volumens
drops	tropfen
automated	automatisches
coupling	kopplung
made	gefertigt
whether	ob
below	unterhalb
infusions	infusionen
rickets	rachitis
murine	murines
stirring	rühren
carbohydrate	kohlenhydrat
et	et
permeability	permeabilität
mutual	gegenseitigen
avoided	vermieden
improving	verbesserung
tourette	tourette-syndrom
percent	prozent
other	andere
contacting	in-kontakt-bringen
june	juni
pumps	pumpen
antepartum	antepartale
radiolabeled	radioaktiv
auxiliary	hilfs-
necrosis	nekrose
